1.000000000000000000e+00 6.198000000000000000e+03 -1.000000000000000000e+00 -1.000000000000000000e+00 -1.000000000000000000e+00 -1.000000000000000000e+00 -1.000000000000000000e+00 1.183900000000000006e+02 1.018423000000000002e+03 1.326999999999999957e+00 2.755000000000000226e-01 7.860000000000000320e-01 6.280000000000000027e-01
2.000000000000000000e+00 6.198000000000000000e+03 -1.000000000000000000e+00 -1.000000000000000000e+00 -1.000000000000000000e+00 -1.000000000000000000e+00 -1.000000000000000000e+00 1.183979999999999961e+02 1.018392000000000053e+03 1.302000000000000046e+00 2.755000000000000226e-01 7.860000000000000320e-01 6.280000000000000027e-01
3.000000000000000000e+00 6.198000000000000000e+03 -1.000000000000000000e+00 -1.000000000000000000e+00 -1.000000000000000000e+00 -1.000000000000000000e+00 -1.000000000000000000e+00 1.184060000000000059e+02 1.018360000000000014e+03 1.276999999999999913e+00 2.755000000000000226e-01 7.860000000000000320e-01 6.280000000000000027e-01
4.000000000000000000e+00 6.198000000000000000e+03 -1.000000000000000000e+00 -1.000000000000000000e+00 -1.000000000000000000e+00 -1.000000000000000000e+00 -1.000000000000000000e+00 1.184140000000000015e+02 1.018328999999999951e+03 1.201999999999999957e+00 2.755000000000000226e-01 7.860000000000000320e-01 6.280000000000000027e-01
5.000000000000000000e+00 6.198000000000000000e+03 -1.000000000000000000e+00 -1.000000000000000000e+00 -1.000000000000000000e+00 -1.000000000000000000e+00 -1.000000000000000000e+00 1.184230000000000018e+02 1.018297000000000025e+03 1.127000000000000002e+00 2.755000000000000226e-01 7.860000000000000320e-01 6.280000000000000027e-01
6.000000000000000000e+00 6.198000000000000000e+03 -1.000000000000000000e+00 -1.000000000000000000e+00 -1.000000000000000000e+00 -1.000000000000000000e+00 -1.000000000000000000e+00 1.184309999999999974e+02 1.018265999999999963e+03 1.026999999999999913e+00 2.755000000000000226e-01 7.860000000000000320e-01 6.280000000000000027e-01
7.000000000000000000e+00 6.198000000000000000e+03 -1.000000000000000000e+00 -1.000000000000000000e+00 -1.000000000000000000e+00 -1.000000000000000000e+00 -1.000000000000000000e+00 1.184389999999999930e+02 1.018235000000000014e+03 9.270000000000000462e-01 2.755000000000000226e-01 7.860000000000000320e-01 6.280000000000000027e-01
8.000000000000000000e+00 6.198000000000000000e+03 -1.000000000000000000e+00 -1.000000000000000000e+00 -1.000000000000000000e+00 -1.000000000000000000e+00 -1.000000000000000000e+00 1.184500000000000028e+02 1.018192999999999984e+03 8.519999999999999796e-01 2.755000000000000226e-01 7.860000000000000320e-01 6.280000000000000027e-01
9.000000000000000000e+00 6.198000000000000000e+03 -1.000000000000000000e+00 -1.000000000000000000e+00 -1.000000000000000000e+00 -1.000000000000000000e+00 -1.000000000000000000e+00 1.184609999999999985e+02 1.018150999999999954e+03 7.770000000000000240e-01 2.755000000000000226e-01 7.860000000000000320e-01 6.280000000000000027e-01
1.000000000000000000e+01 6.198000000000000000e+03 -1.000000000000000000e+00 -1.000000000000000000e+00 -1.000000000000000000e+00 -1.000000000000000000e+00 -1.000000000000000000e+00 1.184609999999999985e+02 1.018150999999999954e+03 7.770000000000000240e-01 2.755000000000000226e-01 7.860000000000000320e-01 6.280000000000000027e-01
1.100000000000000000e+01 6.204000000000000000e+03 -1.000000000000000000e+00 -1.000000000000000000e+00 -1.000000000000000000e+00 -1.000000000000000000e+00 -1.000000000000000000e+00 1.145090000000000003e+02 1.029885999999999967e+03 2.721000000000000085e+00 2.359999999999999876e-01 6.135000000000000453e-01 4.729999999999999760e-01
1.100000000000000000e+01 6.198000000000000000e+03 -1.000000000000000000e+00 -1.000000000000000000e+00 -1.000000000000000000e+00 -1.000000000000000000e+00 -1.000000000000000000e+00 1.184609999999999985e+02 1.018150999999999954e+03 7.770000000000000240e-01 2.755000000000000226e-01 7.860000000000000320e-01 6.280000000000000027e-01
1.200000000000000000e+01 6.204000000000000000e+03 -1.000000000000000000e+00 -1.000000000000000000e+00 -1.000000000000000000e+00 -1.000000000000000000e+00 -1.000000000000000000e+00 1.145090000000000003e+02 1.029885999999999967e+03 2.721000000000000085e+00 2.359999999999999876e-01 6.135000000000000453e-01 4.729999999999999760e-01
1.200000000000000000e+01 6.198000000000000000e+03 -1.000000000000000000e+00 -1.000000000000000000e+00 -1.000000000000000000e+00 -1.000000000000000000e+00 -1.000000000000000000e+00 1.184590000000000032e+02 1.018155999999999949e+03 6.820000000000000506e-01 2.755000000000000226e-01 7.860000000000000320e-01 6.280000000000000027e-01
1.300000000000000000e+01 6.204000000000000000e+03 -1.000000000000000000e+00 -1.000000000000000000e+00 -1.000000000000000000e+00 -1.000000000000000000e+00 -1.000000000000000000e+00 1.145090000000000003e+02 1.029885999999999967e+03 2.721000000000000085e+00 2.359999999999999876e-01 6.135000000000000453e-01 4.729999999999999760e-01
1.300000000000000000e+01 6.198000000000000000e+03 -1.000000000000000000e+00 -1.000000000000000000e+00 -1.000000000000000000e+00 -1.000000000000000000e+00 -1.000000000000000000e+00 1.184579999999999984e+02 1.018160999999999945e+03 5.769999999999999574e-01 2.755000000000000226e-01 7.860000000000000320e-01 6.280000000000000027e-01
1.400000000000000000e+01 6.204000000000000000e+03 -1.000000000000000000e+00 -1.000000000000000000e+00 -1.000000000000000000e+00 -1.000000000000000000e+00 -1.000000000000000000e+00 1.145090000000000003e+02 1.029885999999999967e+03 2.721000000000000085e+00 2.359999999999999876e-01 6.135000000000000453e-01 4.729999999999999760e-01
1.400000000000000000e+01 6.198000000000000000e+03 -1.000000000000000000e+00 -1.000000000000000000e+00 -1.000000000000000000e+00 -1.000000000000000000e+00 -1.000000000000000000e+00 1.184549999999999983e+02 1.018172000000000025e+03 6.710000000000000409e-01 2.755000000000000226e-01 7.860000000000000320e-01 6.280000000000000027e-01
1.500000000000000000e+01 6.204000000000000000e+03 -1.000000000000000000e+00 -1.000000000000000000e+00 -1.000000000000000000e+00 -1.000000000000000000e+00 -1.000000000000000000e+00 1.145090000000000003e+02 1.029885999999999967e+03 2.721000000000000085e+00 2.359999999999999876e-01 6.135000000000000453e-01 4.729999999999999760e-01
1.500000000000000000e+01 6.198000000000000000e+03 -1.000000000000000000e+00 -1.000000000000000000e+00 -1.000000000000000000e+00 -1.000000000000000000e+00 -1.000000000000000000e+00 1.184519999999999982e+02 1.018182999999999993e+03 7.660000000000000142e-01 2.755000000000000226e-01 7.860000000000000320e-01 6.280000000000000027e-01
1.600000000000000000e+01 6.204000000000000000e+03 -1.000000000000000000e+00 -1.000000000000000000e+00 -1.000000000000000000e+00 -1.000000000000000000e+00 -1.000000000000000000e+00 1.145090000000000003e+02 1.029885999999999967e+03 2.721000000000000085e+00 2.359999999999999876e-01 6.135000000000000453e-01 4.729999999999999760e-01
1.600000000000000000e+01 6.198000000000000000e+03 -1.000000000000000000e+00 -1.000000000000000000e+00 -1.000000000000000000e+00 -1.000000000000000000e+00 -1.000000000000000000e+00 1.184170000000000016e+02 1.018145999999999958e+03 7.660000000000000142e-01 2.755000000000000226e-01 7.860000000000000320e-01 6.280000000000000027e-01
1.700000000000000000e+01 6.204000000000000000e+03 -1.000000000000000000e+00 -1.000000000000000000e+00 -1.000000000000000000e+00 -1.000000000000000000e+00 -1.000000000000000000e+00 1.145090000000000003e+02 1.029885999999999967e+03 2.721000000000000085e+00 2.359999999999999876e-01 6.135000000000000453e-01 4.729999999999999760e-01
1.700000000000000000e+01 6.198000000000000000e+03 -1.000000000000000000e+00 -1.000000000000000000e+00 -1.000000000000000000e+00 -1.000000000000000000e+00 -1.000000000000000000e+00 1.183820000000000050e+02 1.018109000000000037e+03 7.660000000000000142e-01 2.755000000000000226e-01 7.860000000000000320e-01 6.280000000000000027e-01
1.800000000000000000e+01 6.198000000000000000e+03 -1.000000000000000000e+00 -1.000000000000000000e+00 -1.000000000000000000e+00 -1.000000000000000000e+00 -1.000000000000000000e+00 1.183870000000000005e+02 1.018110000000000014e+03 7.880000000000000338e-01 2.755000000000000226e-01 7.860000000000000320e-01 6.280000000000000027e-01
1.900000000000000000e+01 6.198000000000000000e+03 -1.000000000000000000e+00 -1.000000000000000000e+00 -1.000000000000000000e+00 -1.000000000000000000e+00 -1.000000000000000000e+00 1.183930000000000007e+02 1.018111999999999966e+03 8.159999999999999476e-01 2.755000000000000226e-01 7.860000000000000320e-01 6.280000000000000027e-01
2.000000000000000000e+01 6.198000000000000000e+03 -1.000000000000000000e+00 -1.000000000000000000e+00 -1.000000000000000000e+00 -1.000000000000000000e+00 -1.000000000000000000e+00 1.183930000000000007e+02 1.018111999999999966e+03 8.159999999999999476e-01 2.755000000000000226e-01 7.860000000000000320e-01 6.280000000000000027e-01
2.100000000000000000e+01 6.198000000000000000e+03 -1.000000000000000000e+00 -1.000000000000000000e+00 -1.000000000000000000e+00 -1.000000000000000000e+00 -1.000000000000000000e+00 1.183930000000000007e+02 1.018111999999999966e+03 8.159999999999999476e-01 2.755000000000000226e-01 7.860000000000000320e-01 6.280000000000000027e-01
2.200000000000000000e+01 6.198000000000000000e+03 -1.000000000000000000e+00 -1.000000000000000000e+00 -1.000000000000000000e+00 -1.000000000000000000e+00 -1.000000000000000000e+00 1.183930000000000007e+02 1.018111999999999966e+03 8.159999999999999476e-01 2.755000000000000226e-01 7.860000000000000320e-01 6.280000000000000027e-01
2.300000000000000000e+01 6.198000000000000000e+03 -1.000000000000000000e+00 -1.000000000000000000e+00 -1.000000000000000000e+00 -1.000000000000000000e+00 -1.000000000000000000e+00 1.183930000000000007e+02 1.018111999999999966e+03 8.159999999999999476e-01 2.755000000000000226e-01 7.860000000000000320e-01 6.280000000000000027e-01
2.400000000000000000e+01 6.198000000000000000e+03 -1.000000000000000000e+00 -1.000000000000000000e+00 -1.000000000000000000e+00 -1.000000000000000000e+00 -1.000000000000000000e+00 1.183930000000000007e+02 1.018111999999999966e+03 8.159999999999999476e-01 2.755000000000000226e-01 7.860000000000000320e-01 6.280000000000000027e-01
2.500000000000000000e+01 6.198000000000000000e+03 -1.000000000000000000e+00 -1.000000000000000000e+00 -1.000000000000000000e+00 -1.000000000000000000e+00 -1.000000000000000000e+00 1.183930000000000007e+02 1.018111999999999966e+03 8.159999999999999476e-01 2.755000000000000226e-01 7.860000000000000320e-01 6.280000000000000027e-01
