8.000000000000000000e+00 4.614000000000000000e+03 -1.000000000000000000e+00 -1.000000000000000000e+00 -1.000000000000000000e+00 -1.000000000000000000e+00 -1.000000000000000000e+00 1.814276000000000067e+03 2.541670999999999822e+03 7.189999999999999725e-01 3.509999999999999787e-01 1.036000000000000032e+00 8.094999999999999973e-01
9.000000000000000000e+00 4.614000000000000000e+03 -1.000000000000000000e+00 -1.000000000000000000e+00 -1.000000000000000000e+00 -1.000000000000000000e+00 -1.000000000000000000e+00 1.813533081374007452e+03 2.542226813194261013e+03 8.845933099013938428e-01 3.509999999999999787e-01 1.036000000000000032e+00 8.094999999999999973e-01
1.000000000000000000e+01 4.614000000000000000e+03 -1.000000000000000000e+00 -1.000000000000000000e+00 -1.000000000000000000e+00 -1.000000000000000000e+00 -1.000000000000000000e+00 1.812790999999999940e+03 2.542782000000000153e+03 1.050000000000000044e+00 3.509999999999999787e-01 1.036000000000000032e+00 8.094999999999999973e-01
1.100000000000000000e+01 4.614000000000000000e+03 -1.000000000000000000e+00 -1.000000000000000000e+00 -1.000000000000000000e+00 -1.000000000000000000e+00 -1.000000000000000000e+00 1.812098999999999933e+03 2.543398999999999887e+03 1.064999999999999947e+00 3.509999999999999787e-01 1.036000000000000032e+00 8.094999999999999973e-01
1.200000000000000000e+01 4.614000000000000000e+03 -1.000000000000000000e+00 -1.000000000000000000e+00 -1.000000000000000000e+00 -1.000000000000000000e+00 -1.000000000000000000e+00 1.811429000000000087e+03 2.543902000000000044e+03 9.499999999999999556e-01 3.509999999999999787e-01 1.036000000000000032e+00 8.094999999999999973e-01
1.300000000000000000e+01 4.614000000000000000e+03 -1.000000000000000000e+00 -1.000000000000000000e+00 -1.000000000000000000e+00 -1.000000000000000000e+00 -1.000000000000000000e+00 1.810778000000000020e+03 2.544432999999999993e+03 9.360000000000000542e-01 3.509999999999999787e-01 1.036000000000000032e+00 8.094999999999999973e-01
1.400000000000000000e+01 4.614000000000000000e+03 -1.000000000000000000e+00 -1.000000000000000000e+00 -1.000000000000000000e+00 -1.000000000000000000e+00 -1.000000000000000000e+00 1.810150000000000091e+03 2.544989000000000033e+03 1.020999999999999908e+00 3.509999999999999787e-01 1.036000000000000032e+00 8.094999999999999973e-01
1.500000000000000000e+01 4.614000000000000000e+03 -1.000000000000000000e+00 -1.000000000000000000e+00 -1.000000000000000000e+00 -1.000000000000000000e+00 -1.000000000000000000e+00 1.809893000000000029e+03 2.545253000000000156e+03 1.155999999999999917e+00 3.509999999999999787e-01 1.036000000000000032e+00 8.094999999999999973e-01
1.600000000000000000e+01 4.614000000000000000e+03 -1.000000000000000000e+00 -1.000000000000000000e+00 -1.000000000000000000e+00 -1.000000000000000000e+00 -1.000000000000000000e+00 1.809815000000000055e+03 2.545324999999999818e+03 1.316999999999999948e+00 3.509999999999999787e-01 1.036000000000000032e+00 8.094999999999999973e-01
1.700000000000000000e+01 4.614000000000000000e+03 -1.000000000000000000e+00 -1.000000000000000000e+00 -1.000000000000000000e+00 -1.000000000000000000e+00 -1.000000000000000000e+00 1.809737000000000080e+03 2.545396000000000186e+03 1.477000000000000091e+00 3.509999999999999787e-01 1.036000000000000032e+00 8.094999999999999973e-01
1.800000000000000000e+01 4.614000000000000000e+03 -1.000000000000000000e+00 -1.000000000000000000e+00 -1.000000000000000000e+00 -1.000000000000000000e+00 -1.000000000000000000e+00 1.809659000000000106e+03 2.545467999999999847e+03 1.637000000000000011e+00 3.509999999999999787e-01 1.036000000000000032e+00 8.094999999999999973e-01
1.900000000000000000e+01 4.614000000000000000e+03 -1.000000000000000000e+00 -1.000000000000000000e+00 -1.000000000000000000e+00 -1.000000000000000000e+00 -1.000000000000000000e+00 1.809580999999999904e+03 2.545539999999999964e+03 1.596999999999999975e+00 3.509999999999999787e-01 1.036000000000000032e+00 8.094999999999999973e-01
2.000000000000000000e+01 4.614000000000000000e+03 -1.000000000000000000e+00 -1.000000000000000000e+00 -1.000000000000000000e+00 -1.000000000000000000e+00 -1.000000000000000000e+00 1.809502999999999929e+03 2.545610999999999876e+03 1.707000000000000073e+00 3.509999999999999787e-01 1.036000000000000032e+00 8.094999999999999973e-01
2.100000000000000000e+01 4.614000000000000000e+03 -1.000000000000000000e+00 -1.000000000000000000e+00 -1.000000000000000000e+00 -1.000000000000000000e+00 -1.000000000000000000e+00 1.809424999999999955e+03 2.545682999999999993e+03 1.818000000000000060e+00 3.509999999999999787e-01 1.036000000000000032e+00 8.094999999999999973e-01
