1.000000000000000000e+00 3.715000000000000000e+03 -1.000000000000000000e+00 -1.000000000000000000e+00 -1.000000000000000000e+00 -1.000000000000000000e+00 -1.000000000000000000e+00 1.713810999999999922e+03 1.267715999999999894e+03 1.028000000000000025e+00 3.659999999999999920e-01 3.880000000000000115e-01 8.844999999999999529e-01
1.000000000000000000e+00 3.720000000000000000e+03 -1.000000000000000000e+00 -1.000000000000000000e+00 -1.000000000000000000e+00 -1.000000000000000000e+00 -1.000000000000000000e+00 1.648000999999999976e+03 1.267403999999999996e+03 1.092000000000000082e+00 3.305000000000000160e-01 3.410000000000000253e-01 7.225000000000000311e-01
1.000000000000000000e+00 3.725000000000000000e+03 -1.000000000000000000e+00 -1.000000000000000000e+00 -1.000000000000000000e+00 -1.000000000000000000e+00 -1.000000000000000000e+00 1.713938000000000102e+03 1.268895999999999958e+03 9.240000000000000435e-01 3.659999999999999920e-01 3.880000000000000115e-01 8.844999999999999529e-01
2.000000000000000000e+00 3.715000000000000000e+03 -1.000000000000000000e+00 -1.000000000000000000e+00 -1.000000000000000000e+00 -1.000000000000000000e+00 -1.000000000000000000e+00 1.713846000000000004e+03 1.267773999999999887e+03 1.002999999999999892e+00 3.659999999999999920e-01 3.880000000000000115e-01 8.844999999999999529e-01
2.000000000000000000e+00 3.720000000000000000e+03 -1.000000000000000000e+00 -1.000000000000000000e+00 -1.000000000000000000e+00 -1.000000000000000000e+00 -1.000000000000000000e+00 1.648019999999999982e+03 1.267373000000000047e+03 1.102000000000000091e+00 3.305000000000000160e-01 3.410000000000000253e-01 7.225000000000000311e-01
2.000000000000000000e+00 3.725000000000000000e+03 -1.000000000000000000e+00 -1.000000000000000000e+00 -1.000000000000000000e+00 -1.000000000000000000e+00 -1.000000000000000000e+00 1.713883000000000038e+03 1.268871000000000095e+03 9.130000000000000338e-01 3.659999999999999920e-01 3.880000000000000115e-01 8.844999999999999529e-01
3.000000000000000000e+00 3.715000000000000000e+03 -1.000000000000000000e+00 -1.000000000000000000e+00 -1.000000000000000000e+00 -1.000000000000000000e+00 -1.000000000000000000e+00 1.713980999999999995e+03 1.268000000000000000e+03 9.779999999999999805e-01 3.659999999999999920e-01 3.880000000000000115e-01 8.844999999999999529e-01
3.000000000000000000e+00 3.720000000000000000e+03 -1.000000000000000000e+00 -1.000000000000000000e+00 -1.000000000000000000e+00 -1.000000000000000000e+00 -1.000000000000000000e+00 1.648039999999999964e+03 1.267343000000000075e+03 1.112000000000000099e+00 3.305000000000000160e-01 3.410000000000000253e-01 7.225000000000000311e-01
3.000000000000000000e+00 3.725000000000000000e+03 -1.000000000000000000e+00 -1.000000000000000000e+00 -1.000000000000000000e+00 -1.000000000000000000e+00 -1.000000000000000000e+00 1.713960000000000036e+03 1.268980000000000018e+03 9.010000000000000231e-01 3.659999999999999920e-01 3.880000000000000115e-01 8.844999999999999529e-01
4.000000000000000000e+00 3.715000000000000000e+03 -1.000000000000000000e+00 -1.000000000000000000e+00 -1.000000000000000000e+00 -1.000000000000000000e+00 -1.000000000000000000e+00 1.714070999999999913e+03 1.268105000000000018e+03 9.150000000000000355e-01 3.659999999999999920e-01 3.880000000000000115e-01 8.844999999999999529e-01
4.000000000000000000e+00 3.720000000000000000e+03 -1.000000000000000000e+00 -1.000000000000000000e+00 -1.000000000000000000e+00 -1.000000000000000000e+00 -1.000000000000000000e+00 1.648058999999999969e+03 1.267311999999999898e+03 1.120999999999999996e+00 3.305000000000000160e-01 3.410000000000000253e-01 7.225000000000000311e-01
4.000000000000000000e+00 3.725000000000000000e+03 -1.000000000000000000e+00 -1.000000000000000000e+00 -1.000000000000000000e+00 -1.000000000000000000e+00 -1.000000000000000000e+00 1.714037000000000035e+03 1.269088999999999942e+03 8.900000000000000133e-01 3.659999999999999920e-01 3.880000000000000115e-01 8.844999999999999529e-01
5.000000000000000000e+00 3.715000000000000000e+03 -1.000000000000000000e+00 -1.000000000000000000e+00 -1.000000000000000000e+00 -1.000000000000000000e+00 -1.000000000000000000e+00 1.714428000000000111e+03 1.268473999999999933e+03 9.190000000000000391e-01 3.659999999999999920e-01 3.880000000000000115e-01 8.844999999999999529e-01
5.000000000000000000e+00 3.725000000000000000e+03 -1.000000000000000000e+00 -1.000000000000000000e+00 -1.000000000000000000e+00 -1.000000000000000000e+00 -1.000000000000000000e+00 1.714482999999999947e+03 1.269332000000000107e+03 8.780000000000000027e-01 3.659999999999999920e-01 3.880000000000000115e-01 8.844999999999999529e-01
6.000000000000000000e+00 3.715000000000000000e+03 -1.000000000000000000e+00 -1.000000000000000000e+00 -1.000000000000000000e+00 -1.000000000000000000e+00 -1.000000000000000000e+00 1.714807999999999993e+03 1.268743999999999915e+03 9.220000000000000417e-01 3.659999999999999920e-01 3.880000000000000115e-01 8.844999999999999529e-01
6.000000000000000000e+00 3.725000000000000000e+03 -1.000000000000000000e+00 -1.000000000000000000e+00 -1.000000000000000000e+00 -1.000000000000000000e+00 -1.000000000000000000e+00 1.714972999999999956e+03 1.269673000000000002e+03 8.669999999999999929e-01 3.659999999999999920e-01 3.880000000000000115e-01 8.844999999999999529e-01
7.000000000000000000e+00 3.715000000000000000e+03 -1.000000000000000000e+00 -1.000000000000000000e+00 -1.000000000000000000e+00 -1.000000000000000000e+00 -1.000000000000000000e+00 1.715230000000000018e+03 1.268943999999999960e+03 9.250000000000000444e-01 3.659999999999999920e-01 3.880000000000000115e-01 8.844999999999999529e-01
7.000000000000000000e+00 3.725000000000000000e+03 -1.000000000000000000e+00 -1.000000000000000000e+00 -1.000000000000000000e+00 -1.000000000000000000e+00 -1.000000000000000000e+00 1.715605000000000018e+03 1.269795000000000073e+03 8.559999999999999831e-01 3.659999999999999920e-01 3.880000000000000115e-01 8.844999999999999529e-01
8.000000000000000000e+00 3.715000000000000000e+03 -1.000000000000000000e+00 -1.000000000000000000e+00 -1.000000000000000000e+00 -1.000000000000000000e+00 -1.000000000000000000e+00 1.715853000000000065e+03 1.268958000000000084e+03 9.290000000000000480e-01 3.659999999999999920e-01 3.880000000000000115e-01 8.844999999999999529e-01
8.000000000000000000e+00 3.725000000000000000e+03 -1.000000000000000000e+00 -1.000000000000000000e+00 -1.000000000000000000e+00 -1.000000000000000000e+00 -1.000000000000000000e+00 1.716247000000000071e+03 1.269859999999999900e+03 8.449999999999999734e-01 3.659999999999999920e-01 3.880000000000000115e-01 8.844999999999999529e-01
9.000000000000000000e+00 3.725000000000000000e+03 -1.000000000000000000e+00 -1.000000000000000000e+00 -1.000000000000000000e+00 -1.000000000000000000e+00 -1.000000000000000000e+00 1.716842000000000098e+03 1.269863000000000056e+03 8.349999999999999645e-01 3.659999999999999920e-01 3.880000000000000115e-01 8.844999999999999529e-01
9.000000000000000000e+00 3.715000000000000000e+03 -1.000000000000000000e+00 -1.000000000000000000e+00 -1.000000000000000000e+00 -1.000000000000000000e+00 -1.000000000000000000e+00 1.716551729881766505e+03 1.268820674322935929e+03 9.321569121164146043e-01 3.659999999999999920e-01 3.880000000000000115e-01 8.844999999999999529e-01
1.000000000000000000e+01 3.715000000000000000e+03 -1.000000000000000000e+00 -1.000000000000000000e+00 -1.000000000000000000e+00 -1.000000000000000000e+00 -1.000000000000000000e+00 1.717181000000000040e+03 1.268696999999999889e+03 9.350000000000000533e-01 3.659999999999999920e-01 3.880000000000000115e-01 8.844999999999999529e-01
1.000000000000000000e+01 3.725000000000000000e+03 -1.000000000000000000e+00 -1.000000000000000000e+00 -1.000000000000000000e+00 -1.000000000000000000e+00 -1.000000000000000000e+00 1.717500999999999976e+03 1.269807999999999993e+03 8.239999999999999547e-01 3.659999999999999920e-01 3.880000000000000115e-01 8.844999999999999529e-01
1.100000000000000000e+01 3.715000000000000000e+03 -1.000000000000000000e+00 -1.000000000000000000e+00 -1.000000000000000000e+00 -1.000000000000000000e+00 -1.000000000000000000e+00 1.717878999999999905e+03 1.268559999999999945e+03 9.379999999999999449e-01 3.659999999999999920e-01 3.880000000000000115e-01 8.844999999999999529e-01
1.100000000000000000e+01 3.725000000000000000e+03 -1.000000000000000000e+00 -1.000000000000000000e+00 -1.000000000000000000e+00 -1.000000000000000000e+00 -1.000000000000000000e+00 1.718066522058978080e+03 1.269680995045994223e+03 8.740019503959304270e-01 3.659999999999999920e-01 3.880000000000000115e-01 8.844999999999999529e-01
1.200000000000000000e+01 3.715000000000000000e+03 -1.000000000000000000e+00 -1.000000000000000000e+00 -1.000000000000000000e+00 -1.000000000000000000e+00 -1.000000000000000000e+00 1.718496000000000095e+03 1.268429000000000087e+03 9.419999999999999485e-01 3.659999999999999920e-01 3.880000000000000115e-01 8.844999999999999529e-01
1.200000000000000000e+01 3.725000000000000000e+03 -1.000000000000000000e+00 -1.000000000000000000e+00 -1.000000000000000000e+00 -1.000000000000000000e+00 -1.000000000000000000e+00 1.718632000000000062e+03 1.269554000000000087e+03 9.240000000000000435e-01 3.659999999999999920e-01 3.880000000000000115e-01 8.844999999999999529e-01
1.300000000000000000e+01 3.715000000000000000e+03 -1.000000000000000000e+00 -1.000000000000000000e+00 -1.000000000000000000e+00 -1.000000000000000000e+00 -1.000000000000000000e+00 1.719144000000000005e+03 1.268298000000000002e+03 9.449999999999999512e-01 3.659999999999999920e-01 3.880000000000000115e-01 8.844999999999999529e-01
1.300000000000000000e+01 3.725000000000000000e+03 -1.000000000000000000e+00 -1.000000000000000000e+00 -1.000000000000000000e+00 -1.000000000000000000e+00 -1.000000000000000000e+00 1.719509000000000015e+03 1.269230000000000018e+03 9.240000000000000435e-01 3.659999999999999920e-01 3.880000000000000115e-01 8.844999999999999529e-01
1.400000000000000000e+01 3.715000000000000000e+03 -1.000000000000000000e+00 -1.000000000000000000e+00 -1.000000000000000000e+00 -1.000000000000000000e+00 -1.000000000000000000e+00 1.719790999999999940e+03 1.268167999999999893e+03 9.479999999999999538e-01 3.659999999999999920e-01 3.880000000000000115e-01 8.844999999999999529e-01
1.400000000000000000e+01 3.725000000000000000e+03 -1.000000000000000000e+00 -1.000000000000000000e+00 -1.000000000000000000e+00 -1.000000000000000000e+00 -1.000000000000000000e+00 1.720099999999999909e+03 1.269067999999999984e+03 9.969999999999999973e-01 3.659999999999999920e-01 3.880000000000000115e-01 8.844999999999999529e-01
1.500000000000000000e+01 3.715000000000000000e+03 -1.000000000000000000e+00 -1.000000000000000000e+00 -1.000000000000000000e+00 -1.000000000000000000e+00 -1.000000000000000000e+00 1.720411000000000058e+03 1.267973999999999933e+03 1.030000000000000027e+00 3.659999999999999920e-01 3.880000000000000115e-01 8.844999999999999529e-01
1.500000000000000000e+01 3.725000000000000000e+03 -1.000000000000000000e+00 -1.000000000000000000e+00 -1.000000000000000000e+00 -1.000000000000000000e+00 -1.000000000000000000e+00 1.720750127235796754e+03 1.268888979456809693e+03 1.078135041504424629e+00 3.659999999999999920e-01 3.880000000000000115e-01 8.844999999999999529e-01
1.600000000000000000e+01 3.715000000000000000e+03 -1.000000000000000000e+00 -1.000000000000000000e+00 -1.000000000000000000e+00 -1.000000000000000000e+00 -1.000000000000000000e+00 1.721090999999999894e+03 1.267759999999999991e+03 1.118999999999999995e+00 3.659999999999999920e-01 3.880000000000000115e-01 8.844999999999999529e-01
1.600000000000000000e+01 3.725000000000000000e+03 -1.000000000000000000e+00 -1.000000000000000000e+00 -1.000000000000000000e+00 -1.000000000000000000e+00 -1.000000000000000000e+00 1.721342000000000098e+03 1.268726000000000113e+03 1.151999999999999913e+00 3.659999999999999920e-01 3.880000000000000115e-01 8.844999999999999529e-01
1.700000000000000000e+01 3.715000000000000000e+03 -1.000000000000000000e+00 -1.000000000000000000e+00 -1.000000000000000000e+00 -1.000000000000000000e+00 -1.000000000000000000e+00 1.721710000000000036e+03 1.267566000000000031e+03 1.199999999999999956e+00 3.659999999999999920e-01 3.880000000000000115e-01 8.844999999999999529e-01
1.700000000000000000e+01 3.725000000000000000e+03 -1.000000000000000000e+00 -1.000000000000000000e+00 -1.000000000000000000e+00 -1.000000000000000000e+00 -1.000000000000000000e+00 1.721932999999999993e+03 1.268563000000000102e+03 1.225999999999999979e+00 3.659999999999999920e-01 3.880000000000000115e-01 8.844999999999999529e-01
1.800000000000000000e+01 3.715000000000000000e+03 -1.000000000000000000e+00 -1.000000000000000000e+00 -1.000000000000000000e+00 -1.000000000000000000e+00 -1.000000000000000000e+00 1.722319999999999936e+03 1.267345000000000027e+03 1.308000000000000052e+00 3.659999999999999920e-01 3.880000000000000115e-01 8.844999999999999529e-01
1.800000000000000000e+01 3.725000000000000000e+03 -1.000000000000000000e+00 -1.000000000000000000e+00 -1.000000000000000000e+00 -1.000000000000000000e+00 -1.000000000000000000e+00 1.722525000000000091e+03 1.268400000000000091e+03 1.300000000000000044e+00 3.659999999999999920e-01 3.880000000000000115e-01 8.844999999999999529e-01
1.900000000000000000e+01 3.715000000000000000e+03 -1.000000000000000000e+00 -1.000000000000000000e+00 -1.000000000000000000e+00 -1.000000000000000000e+00 -1.000000000000000000e+00 1.722930000000000064e+03 1.267124000000000024e+03 1.114999999999999991e+00 3.659999999999999920e-01 3.880000000000000115e-01 8.844999999999999529e-01
1.900000000000000000e+01 3.725000000000000000e+03 -1.000000000000000000e+00 -1.000000000000000000e+00 -1.000000000000000000e+00 -1.000000000000000000e+00 -1.000000000000000000e+00 1.723115999999999985e+03 1.268237000000000080e+03 1.374000000000000110e+00 3.659999999999999920e-01 3.880000000000000115e-01 8.844999999999999529e-01
