1.000000000000000000e+00 6.190000000000000000e+03 -1.000000000000000000e+00 -1.000000000000000000e+00 -1.000000000000000000e+00 -1.000000000000000000e+00 -1.000000000000000000e+00 1.232090000000000032e+02 1.011993000000000052e+03 1.500999999999999890e+00 3.734999999999999987e-01 3.649999999999999911e-01 8.060000000000000497e-01
2.000000000000000000e+00 6.190000000000000000e+03 -1.000000000000000000e+00 -1.000000000000000000e+00 -1.000000000000000000e+00 -1.000000000000000000e+00 -1.000000000000000000e+00 1.230250000000000057e+02 1.012708999999999946e+03 1.491999999999999993e+00 3.734999999999999987e-01 3.649999999999999911e-01 8.060000000000000497e-01
3.000000000000000000e+00 6.190000000000000000e+03 -1.000000000000000000e+00 -1.000000000000000000e+00 -1.000000000000000000e+00 -1.000000000000000000e+00 -1.000000000000000000e+00 1.228379999999999939e+02 1.013423999999999978e+03 1.417000000000000037e+00 3.734999999999999987e-01 3.649999999999999911e-01 8.060000000000000497e-01
4.000000000000000000e+00 6.200000000000000000e+03 -1.000000000000000000e+00 -1.000000000000000000e+00 -1.000000000000000000e+00 -1.000000000000000000e+00 -1.000000000000000000e+00 1.114419999999999931e+02 1.040018000000000029e+03 3.424999999999999822e+00 3.039999999999999925e-01 2.755000000000000226e-01 8.020000000000000462e-01
4.000000000000000000e+00 6.190000000000000000e+03 -1.000000000000000000e+00 -1.000000000000000000e+00 -1.000000000000000000e+00 -1.000000000000000000e+00 -1.000000000000000000e+00 1.226500000000000057e+02 1.014139000000000010e+03 1.342000000000000082e+00 3.734999999999999987e-01 3.649999999999999911e-01 8.060000000000000497e-01
5.000000000000000000e+00 6.200000000000000000e+03 -1.000000000000000000e+00 -1.000000000000000000e+00 -1.000000000000000000e+00 -1.000000000000000000e+00 -1.000000000000000000e+00 1.115639999999999930e+02 1.039508000000000038e+03 3.350000000000000089e+00 3.039999999999999925e-01 2.755000000000000226e-01 8.020000000000000462e-01
5.000000000000000000e+00 6.190000000000000000e+03 -1.000000000000000000e+00 -1.000000000000000000e+00 -1.000000000000000000e+00 -1.000000000000000000e+00 -1.000000000000000000e+00 1.224350000000000023e+02 1.014839000000000055e+03 1.274999999999999911e+00 3.734999999999999987e-01 3.649999999999999911e-01 8.060000000000000497e-01
6.000000000000000000e+00 6.190000000000000000e+03 -1.000000000000000000e+00 -1.000000000000000000e+00 -1.000000000000000000e+00 -1.000000000000000000e+00 -1.000000000000000000e+00 1.222210000000000036e+02 1.015539999999999964e+03 1.209000000000000075e+00 3.734999999999999987e-01 3.649999999999999911e-01 8.060000000000000497e-01
6.000000000000000000e+00 6.200000000000000000e+03 -1.000000000000000000e+00 -1.000000000000000000e+00 -1.000000000000000000e+00 -1.000000000000000000e+00 -1.000000000000000000e+00 1.118066286645710790e+02 1.038488159734083183e+03 3.200023490306334040e+00 3.039999999999999925e-01 2.755000000000000226e-01 8.020000000000000462e-01
7.000000000000000000e+00 6.190000000000000000e+03 -1.000000000000000000e+00 -1.000000000000000000e+00 -1.000000000000000000e+00 -1.000000000000000000e+00 -1.000000000000000000e+00 1.220060000000000002e+02 1.016240000000000009e+03 1.141999999999999904e+00 3.734999999999999987e-01 3.649999999999999911e-01 8.060000000000000497e-01
7.000000000000000000e+00 6.200000000000000000e+03 -1.000000000000000000e+00 -1.000000000000000000e+00 -1.000000000000000000e+00 -1.000000000000000000e+00 -1.000000000000000000e+00 1.116853883150886304e+02 1.038997768895369063e+03 3.274966014024879080e+00 3.039999999999999925e-01 2.755000000000000226e-01 8.020000000000000462e-01
8.000000000000000000e+00 6.200000000000000000e+03 -1.000000000000000000e+00 -1.000000000000000000e+00 -1.000000000000000000e+00 -1.000000000000000000e+00 -1.000000000000000000e+00 1.119279999999999973e+02 1.037978000000000065e+03 3.125000000000000000e+00 3.039999999999999925e-01 2.755000000000000226e-01 8.020000000000000462e-01
8.000000000000000000e+00 6.202000000000000000e+03 -1.000000000000000000e+00 -1.000000000000000000e+00 -1.000000000000000000e+00 -1.000000000000000000e+00 -1.000000000000000000e+00 1.127309999999999945e+02 1.038310999999999922e+03 3.140000000000000124e+00 3.235000000000000098e-01 1.940000000000000058e-01 8.415000000000000258e-01
8.000000000000000000e+00 6.190000000000000000e+03 -1.000000000000000000e+00 -1.000000000000000000e+00 -1.000000000000000000e+00 -1.000000000000000000e+00 -1.000000000000000000e+00 1.217549999999999955e+02 1.016799999999999955e+03 1.092000000000000082e+00 3.734999999999999987e-01 3.649999999999999911e-01 8.060000000000000497e-01
9.000000000000000000e+00 6.200000000000000000e+03 -1.000000000000000000e+00 -1.000000000000000000e+00 -1.000000000000000000e+00 -1.000000000000000000e+00 -1.000000000000000000e+00 1.120930000000000035e+02 1.037416999999999916e+03 3.049999999999999822e+00 3.039999999999999925e-01 2.755000000000000226e-01 8.020000000000000462e-01
9.000000000000000000e+00 6.202000000000000000e+03 -1.000000000000000000e+00 -1.000000000000000000e+00 -1.000000000000000000e+00 -1.000000000000000000e+00 -1.000000000000000000e+00 1.128820000000000050e+02 1.037758000000000038e+03 3.064999999999999947e+00 3.235000000000000098e-01 1.940000000000000058e-01 8.415000000000000258e-01
9.000000000000000000e+00 6.190000000000000000e+03 -1.000000000000000000e+00 -1.000000000000000000e+00 -1.000000000000000000e+00 -1.000000000000000000e+00 -1.000000000000000000e+00 1.213389999999999986e+02 1.017283999999999992e+03 1.066999999999999948e+00 3.734999999999999987e-01 3.649999999999999911e-01 8.060000000000000497e-01
1.000000000000000000e+01 6.200000000000000000e+03 -1.000000000000000000e+00 -1.000000000000000000e+00 -1.000000000000000000e+00 -1.000000000000000000e+00 -1.000000000000000000e+00 1.122429999999999950e+02 1.036824000000000069e+03 2.975000000000000089e+00 3.039999999999999925e-01 2.755000000000000226e-01 8.020000000000000462e-01
1.000000000000000000e+01 6.202000000000000000e+03 -1.000000000000000000e+00 -1.000000000000000000e+00 -1.000000000000000000e+00 -1.000000000000000000e+00 -1.000000000000000000e+00 1.130330000000000013e+02 1.037203999999999951e+03 2.990000000000000213e+00 3.235000000000000098e-01 1.940000000000000058e-01 8.415000000000000258e-01
1.000000000000000000e+01 6.190000000000000000e+03 -1.000000000000000000e+00 -1.000000000000000000e+00 -1.000000000000000000e+00 -1.000000000000000000e+00 -1.000000000000000000e+00 1.209230000000000018e+02 1.017768000000000029e+03 1.042000000000000037e+00 3.734999999999999987e-01 3.649999999999999911e-01 8.060000000000000497e-01
1.100000000000000000e+01 6.200000000000000000e+03 -1.000000000000000000e+00 -1.000000000000000000e+00 -1.000000000000000000e+00 -1.000000000000000000e+00 -1.000000000000000000e+00 1.123940000000000055e+02 1.036232999999999947e+03 2.899999999999999911e+00 3.039999999999999925e-01 2.755000000000000226e-01 8.020000000000000462e-01
1.100000000000000000e+01 6.202000000000000000e+03 -1.000000000000000000e+00 -1.000000000000000000e+00 -1.000000000000000000e+00 -1.000000000000000000e+00 -1.000000000000000000e+00 1.131880000000000024e+02 1.036653999999999996e+03 2.990000000000000213e+00 3.235000000000000098e-01 1.940000000000000058e-01 8.415000000000000258e-01
1.100000000000000000e+01 6.190000000000000000e+03 -1.000000000000000000e+00 -1.000000000000000000e+00 -1.000000000000000000e+00 -1.000000000000000000e+00 -1.000000000000000000e+00 1.205100000000000051e+02 1.018451999999999998e+03 9.899999999999999911e-01 3.734999999999999987e-01 3.649999999999999911e-01 8.060000000000000497e-01
1.100000000000000000e+01 6.205000000000000000e+03 -1.000000000000000000e+00 -1.000000000000000000e+00 -1.000000000000000000e+00 -1.000000000000000000e+00 -1.000000000000000000e+00 1.125729999999999933e+02 1.038563000000000102e+03 2.890000000000000124e+00 2.525000000000000022e-01 2.665000000000000147e-01 8.415000000000000258e-01
1.200000000000000000e+01 6.200000000000000000e+03 -1.000000000000000000e+00 -1.000000000000000000e+00 -1.000000000000000000e+00 -1.000000000000000000e+00 -1.000000000000000000e+00 1.125619999999999976e+02 1.035739000000000033e+03 2.899999999999999911e+00 3.039999999999999925e-01 2.755000000000000226e-01 8.020000000000000462e-01
1.200000000000000000e+01 6.202000000000000000e+03 -1.000000000000000000e+00 -1.000000000000000000e+00 -1.000000000000000000e+00 -1.000000000000000000e+00 -1.000000000000000000e+00 1.133280000000000030e+02 1.036160000000000082e+03 2.990000000000000213e+00 3.235000000000000098e-01 1.940000000000000058e-01 8.415000000000000258e-01
1.200000000000000000e+01 6.190000000000000000e+03 -1.000000000000000000e+00 -1.000000000000000000e+00 -1.000000000000000000e+00 -1.000000000000000000e+00 -1.000000000000000000e+00 1.202039999999999935e+02 1.019102999999999952e+03 9.419999999999999485e-01 3.734999999999999987e-01 3.649999999999999911e-01 8.060000000000000497e-01
1.200000000000000000e+01 6.206000000000000000e+03 -1.000000000000000000e+00 -1.000000000000000000e+00 -1.000000000000000000e+00 -1.000000000000000000e+00 -1.000000000000000000e+00 1.103299999999999983e+02 1.054594000000000051e+03 2.763999999999999790e+00 2.710000000000000187e-01 2.580000000000000071e-01 8.549999999999999822e-01
1.200000000000000000e+01 6.205000000000000000e+03 -1.000000000000000000e+00 -1.000000000000000000e+00 -1.000000000000000000e+00 -1.000000000000000000e+00 -1.000000000000000000e+00 1.126487337625062821e+02 1.038061263823396075e+03 2.890000000000000124e+00 2.525000000000000022e-01 2.665000000000000147e-01 8.415000000000000258e-01
1.300000000000000000e+01 6.200000000000000000e+03 -1.000000000000000000e+00 -1.000000000000000000e+00 -1.000000000000000000e+00 -1.000000000000000000e+00 -1.000000000000000000e+00 1.127489999999999952e+02 1.035191000000000031e+03 2.899999999999999911e+00 3.039999999999999925e-01 2.755000000000000226e-01 8.020000000000000462e-01
1.300000000000000000e+01 6.202000000000000000e+03 -1.000000000000000000e+00 -1.000000000000000000e+00 -1.000000000000000000e+00 -1.000000000000000000e+00 -1.000000000000000000e+00 1.135090000000000003e+02 1.035684999999999945e+03 2.990000000000000213e+00 3.235000000000000098e-01 1.940000000000000058e-01 8.415000000000000258e-01
1.300000000000000000e+01 6.190000000000000000e+03 -1.000000000000000000e+00 -1.000000000000000000e+00 -1.000000000000000000e+00 -1.000000000000000000e+00 -1.000000000000000000e+00 1.199800000000000040e+02 1.019738000000000056e+03 8.880000000000000115e-01 3.734999999999999987e-01 3.649999999999999911e-01 8.060000000000000497e-01
1.300000000000000000e+01 6.206000000000000000e+03 -1.000000000000000000e+00 -1.000000000000000000e+00 -1.000000000000000000e+00 -1.000000000000000000e+00 -1.000000000000000000e+00 1.104360000000000070e+02 1.053851000000000113e+03 2.794999999999999929e+00 2.710000000000000187e-01 2.580000000000000071e-01 8.549999999999999822e-01
1.300000000000000000e+01 6.205000000000000000e+03 -1.000000000000000000e+00 -1.000000000000000000e+00 -1.000000000000000000e+00 -1.000000000000000000e+00 -1.000000000000000000e+00 1.127169999999999987e+02 1.037608999999999924e+03 2.890000000000000124e+00 2.525000000000000022e-01 2.665000000000000147e-01 8.415000000000000258e-01
1.400000000000000000e+01 6.200000000000000000e+03 -1.000000000000000000e+00 -1.000000000000000000e+00 -1.000000000000000000e+00 -1.000000000000000000e+00 -1.000000000000000000e+00 1.129410000000000025e+02 1.034762999999999920e+03 2.950000000000000178e+00 3.039999999999999925e-01 2.755000000000000226e-01 8.020000000000000462e-01
1.400000000000000000e+01 6.202000000000000000e+03 -1.000000000000000000e+00 -1.000000000000000000e+00 -1.000000000000000000e+00 -1.000000000000000000e+00 -1.000000000000000000e+00 1.136899999999999977e+02 1.035210000000000036e+03 2.990000000000000213e+00 3.235000000000000098e-01 1.940000000000000058e-01 8.415000000000000258e-01
1.400000000000000000e+01 6.190000000000000000e+03 -1.000000000000000000e+00 -1.000000000000000000e+00 -1.000000000000000000e+00 -1.000000000000000000e+00 -1.000000000000000000e+00 1.197549999999999955e+02 1.020374000000000024e+03 8.339999999999999636e-01 3.734999999999999987e-01 3.649999999999999911e-01 8.060000000000000497e-01
1.400000000000000000e+01 6.206000000000000000e+03 -1.000000000000000000e+00 -1.000000000000000000e+00 -1.000000000000000000e+00 -1.000000000000000000e+00 -1.000000000000000000e+00 1.105430000000000064e+02 1.053106999999999971e+03 2.825000000000000178e+00 2.710000000000000187e-01 2.580000000000000071e-01 8.549999999999999822e-01
1.400000000000000000e+01 6.205000000000000000e+03 -1.000000000000000000e+00 -1.000000000000000000e+00 -1.000000000000000000e+00 -1.000000000000000000e+00 -1.000000000000000000e+00 1.128160000000000025e+02 1.037114000000000033e+03 2.890000000000000124e+00 2.525000000000000022e-01 2.665000000000000147e-01 8.415000000000000258e-01
1.500000000000000000e+01 6.200000000000000000e+03 -1.000000000000000000e+00 -1.000000000000000000e+00 -1.000000000000000000e+00 -1.000000000000000000e+00 -1.000000000000000000e+00 1.131340000000000003e+02 1.034335000000000036e+03 3.000000000000000000e+00 3.039999999999999925e-01 2.755000000000000226e-01 8.020000000000000462e-01
1.500000000000000000e+01 6.202000000000000000e+03 -1.000000000000000000e+00 -1.000000000000000000e+00 -1.000000000000000000e+00 -1.000000000000000000e+00 -1.000000000000000000e+00 1.138139999999999930e+02 1.034836000000000013e+03 2.990000000000000213e+00 3.235000000000000098e-01 1.940000000000000058e-01 8.415000000000000258e-01
1.500000000000000000e+01 6.190000000000000000e+03 -1.000000000000000000e+00 -1.000000000000000000e+00 -1.000000000000000000e+00 -1.000000000000000000e+00 -1.000000000000000000e+00 1.195610000000000070e+02 1.021196000000000026e+03 9.549999999999999600e-01 3.734999999999999987e-01 3.649999999999999911e-01 8.060000000000000497e-01
1.500000000000000000e+01 6.206000000000000000e+03 -1.000000000000000000e+00 -1.000000000000000000e+00 -1.000000000000000000e+00 -1.000000000000000000e+00 -1.000000000000000000e+00 1.106479999999999961e+02 1.052430000000000064e+03 2.931000000000000050e+00 2.710000000000000187e-01 2.580000000000000071e-01 8.549999999999999822e-01
1.500000000000000000e+01 6.205000000000000000e+03 -1.000000000000000000e+00 -1.000000000000000000e+00 -1.000000000000000000e+00 -1.000000000000000000e+00 -1.000000000000000000e+00 1.129159999999999968e+02 1.036617999999999938e+03 2.890000000000000124e+00 2.525000000000000022e-01 2.665000000000000147e-01 8.415000000000000258e-01
1.600000000000000000e+01 6.200000000000000000e+03 -1.000000000000000000e+00 -1.000000000000000000e+00 -1.000000000000000000e+00 -1.000000000000000000e+00 -1.000000000000000000e+00 1.133029999999999973e+02 1.033906999999999925e+03 2.950000000000000178e+00 3.039999999999999925e-01 2.755000000000000226e-01 8.020000000000000462e-01
1.600000000000000000e+01 6.190000000000000000e+03 -1.000000000000000000e+00 -1.000000000000000000e+00 -1.000000000000000000e+00 -1.000000000000000000e+00 -1.000000000000000000e+00 1.190979999999999990e+02 1.021902000000000044e+03 1.076999999999999957e+00 3.734999999999999987e-01 3.649999999999999911e-01 8.060000000000000497e-01
1.600000000000000000e+01 6.206000000000000000e+03 -1.000000000000000000e+00 -1.000000000000000000e+00 -1.000000000000000000e+00 -1.000000000000000000e+00 -1.000000000000000000e+00 1.107530000000000001e+02 1.051752999999999929e+03 3.036000000000000032e+00 2.710000000000000187e-01 2.580000000000000071e-01 8.549999999999999822e-01
1.700000000000000000e+01 6.190000000000000000e+03 -1.000000000000000000e+00 -1.000000000000000000e+00 -1.000000000000000000e+00 -1.000000000000000000e+00 -1.000000000000000000e+00 1.186280000000000001e+02 1.022399000000000001e+03 1.102999999999999980e+00 3.734999999999999987e-01 3.649999999999999911e-01 8.060000000000000497e-01
1.700000000000000000e+01 6.206000000000000000e+03 -1.000000000000000000e+00 -1.000000000000000000e+00 -1.000000000000000000e+00 -1.000000000000000000e+00 -1.000000000000000000e+00 1.108960000000000008e+02 1.051048000000000002e+03 3.092000000000000082e+00 2.710000000000000187e-01 2.580000000000000071e-01 8.549999999999999822e-01
1.800000000000000000e+01 6.190000000000000000e+03 -1.000000000000000000e+00 -1.000000000000000000e+00 -1.000000000000000000e+00 -1.000000000000000000e+00 -1.000000000000000000e+00 1.182510000000000048e+02 1.022798000000000002e+03 1.125000000000000000e+00 3.734999999999999987e-01 3.649999999999999911e-01 8.060000000000000497e-01
1.800000000000000000e+01 6.206000000000000000e+03 -1.000000000000000000e+00 -1.000000000000000000e+00 -1.000000000000000000e+00 -1.000000000000000000e+00 -1.000000000000000000e+00 1.110109999999999957e+02 1.050483999999999924e+03 3.136000000000000121e+00 2.710000000000000187e-01 2.580000000000000071e-01 8.549999999999999822e-01
1.900000000000000000e+01 6.190000000000000000e+03 -1.000000000000000000e+00 -1.000000000000000000e+00 -1.000000000000000000e+00 -1.000000000000000000e+00 -1.000000000000000000e+00 1.177800000000000011e+02 1.023538000000000011e+03 1.104999999999999982e+00 3.734999999999999987e-01 3.649999999999999911e-01 8.060000000000000497e-01
1.900000000000000000e+01 6.206000000000000000e+03 -1.000000000000000000e+00 -1.000000000000000000e+00 -1.000000000000000000e+00 -1.000000000000000000e+00 -1.000000000000000000e+00 1.111485850415024572e+02 1.049827594274722742e+03 3.136000000000000121e+00 2.710000000000000187e-01 2.580000000000000071e-01 8.549999999999999822e-01
2.000000000000000000e+01 6.190000000000000000e+03 -1.000000000000000000e+00 -1.000000000000000000e+00 -1.000000000000000000e+00 -1.000000000000000000e+00 -1.000000000000000000e+00 1.174380000000000024e+02 1.024296000000000049e+03 1.177999999999999936e+00 3.734999999999999987e-01 3.649999999999999911e-01 8.060000000000000497e-01
2.000000000000000000e+01 6.206000000000000000e+03 -1.000000000000000000e+00 -1.000000000000000000e+00 -1.000000000000000000e+00 -1.000000000000000000e+00 -1.000000000000000000e+00 1.112860000000000014e+02 1.049172000000000025e+03 3.136000000000000121e+00 2.710000000000000187e-01 2.580000000000000071e-01 8.549999999999999822e-01
2.100000000000000000e+01 6.206000000000000000e+03 -1.000000000000000000e+00 -1.000000000000000000e+00 -1.000000000000000000e+00 -1.000000000000000000e+00 -1.000000000000000000e+00 1.114230000000000018e+02 1.048517000000000053e+03 3.136000000000000121e+00 2.710000000000000187e-01 2.580000000000000071e-01 8.549999999999999822e-01
2.200000000000000000e+01 6.206000000000000000e+03 -1.000000000000000000e+00 -1.000000000000000000e+00 -1.000000000000000000e+00 -1.000000000000000000e+00 -1.000000000000000000e+00 1.115090000000000003e+02 1.047799999999999955e+03 3.136000000000000121e+00 2.710000000000000187e-01 2.580000000000000071e-01 8.549999999999999822e-01
2.300000000000000000e+01 6.206000000000000000e+03 -1.000000000000000000e+00 -1.000000000000000000e+00 -1.000000000000000000e+00 -1.000000000000000000e+00 -1.000000000000000000e+00 1.115939999999999941e+02 1.047083000000000084e+03 3.136000000000000121e+00 2.710000000000000187e-01 2.580000000000000071e-01 8.549999999999999822e-01
2.400000000000000000e+01 6.206000000000000000e+03 -1.000000000000000000e+00 -1.000000000000000000e+00 -1.000000000000000000e+00 -1.000000000000000000e+00 -1.000000000000000000e+00 1.116740000000000066e+02 1.046407999999999902e+03 3.136000000000000121e+00 2.710000000000000187e-01 2.580000000000000071e-01 8.549999999999999822e-01
2.500000000000000000e+01 6.206000000000000000e+03 -1.000000000000000000e+00 -1.000000000000000000e+00 -1.000000000000000000e+00 -1.000000000000000000e+00 -1.000000000000000000e+00 1.117549999999999955e+02 1.045731999999999971e+03 3.136000000000000121e+00 2.710000000000000187e-01 2.580000000000000071e-01 8.549999999999999822e-01
2.600000000000000000e+01 6.206000000000000000e+03 -1.000000000000000000e+00 -1.000000000000000000e+00 -1.000000000000000000e+00 -1.000000000000000000e+00 -1.000000000000000000e+00 1.118469999999999942e+02 1.045154999999999973e+03 3.136000000000000121e+00 2.710000000000000187e-01 2.580000000000000071e-01 8.549999999999999822e-01
2.700000000000000000e+01 6.206000000000000000e+03 -1.000000000000000000e+00 -1.000000000000000000e+00 -1.000000000000000000e+00 -1.000000000000000000e+00 -1.000000000000000000e+00 1.119380000000000024e+02 1.044576999999999998e+03 3.136000000000000121e+00 2.710000000000000187e-01 2.580000000000000071e-01 8.549999999999999822e-01
2.800000000000000000e+01 6.206000000000000000e+03 -1.000000000000000000e+00 -1.000000000000000000e+00 -1.000000000000000000e+00 -1.000000000000000000e+00 -1.000000000000000000e+00 1.120469999999999970e+02 1.044070999999999913e+03 3.246999999999999886e+00 2.710000000000000187e-01 2.580000000000000071e-01 8.549999999999999822e-01
2.900000000000000000e+01 6.206000000000000000e+03 -1.000000000000000000e+00 -1.000000000000000000e+00 -1.000000000000000000e+00 -1.000000000000000000e+00 -1.000000000000000000e+00 1.121830000000000069e+02 1.043440000000000055e+03 3.386000000000000121e+00 2.710000000000000187e-01 2.580000000000000071e-01 8.549999999999999822e-01
3.000000000000000000e+01 6.206000000000000000e+03 -1.000000000000000000e+00 -1.000000000000000000e+00 -1.000000000000000000e+00 -1.000000000000000000e+00 -1.000000000000000000e+00 1.123610000000000042e+02 1.042685999999999922e+03 3.261000000000000121e+00 2.710000000000000187e-01 2.580000000000000071e-01 8.549999999999999822e-01
3.100000000000000000e+01 6.206000000000000000e+03 -1.000000000000000000e+00 -1.000000000000000000e+00 -1.000000000000000000e+00 -1.000000000000000000e+00 -1.000000000000000000e+00 1.125390000000000015e+02 1.041932999999999993e+03 3.136000000000000121e+00 2.710000000000000187e-01 2.580000000000000071e-01 8.549999999999999822e-01
