9.000000000000000000e+00 7.230000000000000000e+02 -1.000000000000000000e+00 -1.000000000000000000e+00 -1.000000000000000000e+00 -1.000000000000000000e+00 -1.000000000000000000e+00 1.291309999999999945e+03 1.067400000000000091e+03 1.250999999999999890e+00 3.729999999999999982e-01 9.130000000000000338e-01 9.379999999999999449e-01
1.000000000000000000e+01 7.230000000000000000e+02 -1.000000000000000000e+00 -1.000000000000000000e+00 -1.000000000000000000e+00 -1.000000000000000000e+00 -1.000000000000000000e+00 1.291311999999999898e+03 1.067398999999999887e+03 1.219999999999999973e+00 3.729999999999999982e-01 9.130000000000000338e-01 9.379999999999999449e-01
1.100000000000000000e+01 7.230000000000000000e+02 -1.000000000000000000e+00 -1.000000000000000000e+00 -1.000000000000000000e+00 -1.000000000000000000e+00 -1.000000000000000000e+00 1.291314000000000078e+03 1.067397999999999911e+03 1.189000000000000057e+00 3.729999999999999982e-01 9.130000000000000338e-01 9.379999999999999449e-01
1.200000000000000000e+01 7.230000000000000000e+02 -1.000000000000000000e+00 -1.000000000000000000e+00 -1.000000000000000000e+00 -1.000000000000000000e+00 -1.000000000000000000e+00 1.291316000000000031e+03 1.067396999999999935e+03 1.157999999999999918e+00 3.729999999999999982e-01 9.130000000000000338e-01 9.379999999999999449e-01
1.300000000000000000e+01 7.230000000000000000e+02 -1.000000000000000000e+00 -1.000000000000000000e+00 -1.000000000000000000e+00 -1.000000000000000000e+00 -1.000000000000000000e+00 1.291317999999999984e+03 1.067395999999999958e+03 1.127999999999999892e+00 3.729999999999999982e-01 9.130000000000000338e-01 9.379999999999999449e-01
1.400000000000000000e+01 7.230000000000000000e+02 -1.000000000000000000e+00 -1.000000000000000000e+00 -1.000000000000000000e+00 -1.000000000000000000e+00 -1.000000000000000000e+00 1.291320999999999913e+03 1.067394999999999982e+03 1.096999999999999975e+00 3.729999999999999982e-01 9.130000000000000338e-01 9.379999999999999449e-01
1.500000000000000000e+01 7.230000000000000000e+02 -1.000000000000000000e+00 -1.000000000000000000e+00 -1.000000000000000000e+00 -1.000000000000000000e+00 -1.000000000000000000e+00 1.290836999999999989e+03 1.066892000000000053e+03 1.096999999999999975e+00 3.729999999999999982e-01 9.130000000000000338e-01 9.379999999999999449e-01
1.600000000000000000e+01 7.230000000000000000e+02 -1.000000000000000000e+00 -1.000000000000000000e+00 -1.000000000000000000e+00 -1.000000000000000000e+00 -1.000000000000000000e+00 1.290326000000000022e+03 1.066415999999999940e+03 1.096999999999999975e+00 3.729999999999999982e-01 9.130000000000000338e-01 9.379999999999999449e-01
1.700000000000000000e+01 7.230000000000000000e+02 -1.000000000000000000e+00 -1.000000000000000000e+00 -1.000000000000000000e+00 -1.000000000000000000e+00 -1.000000000000000000e+00 1.289637999999999920e+03 1.065813000000000102e+03 1.096999999999999975e+00 3.729999999999999982e-01 9.130000000000000338e-01 9.379999999999999449e-01
1.800000000000000000e+01 7.230000000000000000e+02 -1.000000000000000000e+00 -1.000000000000000000e+00 -1.000000000000000000e+00 -1.000000000000000000e+00 -1.000000000000000000e+00 1.288800999999999931e+03 1.065240999999999985e+03 1.096999999999999975e+00 3.729999999999999982e-01 9.130000000000000338e-01 9.379999999999999449e-01
1.900000000000000000e+01 7.230000000000000000e+02 -1.000000000000000000e+00 -1.000000000000000000e+00 -1.000000000000000000e+00 -1.000000000000000000e+00 -1.000000000000000000e+00 1.287936999999999898e+03 1.064589999999999918e+03 1.096999999999999975e+00 3.729999999999999982e-01 9.130000000000000338e-01 9.379999999999999449e-01
2.000000000000000000e+01 7.230000000000000000e+02 -1.000000000000000000e+00 -1.000000000000000000e+00 -1.000000000000000000e+00 -1.000000000000000000e+00 -1.000000000000000000e+00 1.287096999999999980e+03 1.063892000000000053e+03 1.096999999999999975e+00 3.729999999999999982e-01 9.130000000000000338e-01 9.379999999999999449e-01
2.100000000000000000e+01 7.230000000000000000e+02 -1.000000000000000000e+00 -1.000000000000000000e+00 -1.000000000000000000e+00 -1.000000000000000000e+00 -1.000000000000000000e+00 1.286138999999999896e+03 1.062983999999999924e+03 1.096999999999999975e+00 3.729999999999999982e-01 9.130000000000000338e-01 9.379999999999999449e-01
2.200000000000000000e+01 7.230000000000000000e+02 -1.000000000000000000e+00 -1.000000000000000000e+00 -1.000000000000000000e+00 -1.000000000000000000e+00 -1.000000000000000000e+00 1.285263999999999896e+03 1.061890000000000100e+03 1.096999999999999975e+00 3.729999999999999982e-01 9.130000000000000338e-01 9.379999999999999449e-01
2.300000000000000000e+01 7.230000000000000000e+02 -1.000000000000000000e+00 -1.000000000000000000e+00 -1.000000000000000000e+00 -1.000000000000000000e+00 -1.000000000000000000e+00 1.284511999999999944e+03 1.060596000000000004e+03 1.046999999999999931e+00 3.729999999999999982e-01 9.130000000000000338e-01 9.379999999999999449e-01
2.400000000000000000e+01 7.230000000000000000e+02 -1.000000000000000000e+00 -1.000000000000000000e+00 -1.000000000000000000e+00 -1.000000000000000000e+00 -1.000000000000000000e+00 1.283730000000000018e+03 1.059203999999999951e+03 9.969999999999999973e-01 3.729999999999999982e-01 9.130000000000000338e-01 9.379999999999999449e-01
2.500000000000000000e+01 7.230000000000000000e+02 -1.000000000000000000e+00 -1.000000000000000000e+00 -1.000000000000000000e+00 -1.000000000000000000e+00 -1.000000000000000000e+00 1.282684999999999945e+03 1.057557000000000016e+03 9.469999999999999529e-01 3.729999999999999982e-01 9.130000000000000338e-01 9.379999999999999449e-01
2.600000000000000000e+01 7.230000000000000000e+02 -1.000000000000000000e+00 -1.000000000000000000e+00 -1.000000000000000000e+00 -1.000000000000000000e+00 -1.000000000000000000e+00 1.281502999999999929e+03 1.056042999999999893e+03 8.970000000000000195e-01 3.729999999999999982e-01 9.130000000000000338e-01 9.379999999999999449e-01
