1.000000000000000000e+00 2.571000000000000000e+03 -1.000000000000000000e+00 -1.000000000000000000e+00 -1.000000000000000000e+00 -1.000000000000000000e+00 -1.000000000000000000e+00 3.580880000000000223e+02 1.088807000000000016e+03 7.459999999999999964e-01 3.980000000000000204e-01 1.099499999999999922e+00 8.685000000000000497e-01
2.000000000000000000e+00 2.571000000000000000e+03 -1.000000000000000000e+00 -1.000000000000000000e+00 -1.000000000000000000e+00 -1.000000000000000000e+00 -1.000000000000000000e+00 3.586739999999999782e+02 1.090445999999999913e+03 7.459999999999999964e-01 3.980000000000000204e-01 1.099499999999999922e+00 8.685000000000000497e-01
3.000000000000000000e+00 2.571000000000000000e+03 -1.000000000000000000e+00 -1.000000000000000000e+00 -1.000000000000000000e+00 -1.000000000000000000e+00 -1.000000000000000000e+00 3.590840000000000032e+02 1.091958000000000084e+03 7.459999999999999964e-01 3.980000000000000204e-01 1.099499999999999922e+00 8.685000000000000497e-01
4.000000000000000000e+00 2.571000000000000000e+03 -1.000000000000000000e+00 -1.000000000000000000e+00 -1.000000000000000000e+00 -1.000000000000000000e+00 -1.000000000000000000e+00 3.593360000000000127e+02 1.093318999999999960e+03 7.459999999999999964e-01 3.980000000000000204e-01 1.099499999999999922e+00 8.685000000000000497e-01
5.000000000000000000e+00 2.571000000000000000e+03 -1.000000000000000000e+00 -1.000000000000000000e+00 -1.000000000000000000e+00 -1.000000000000000000e+00 -1.000000000000000000e+00 3.595330000000000155e+02 1.094689000000000078e+03 7.459999999999999964e-01 3.980000000000000204e-01 1.099499999999999922e+00 8.685000000000000497e-01
6.000000000000000000e+00 2.571000000000000000e+03 -1.000000000000000000e+00 -1.000000000000000000e+00 -1.000000000000000000e+00 -1.000000000000000000e+00 -1.000000000000000000e+00 3.596600000000000250e+02 1.096256000000000085e+03 7.459999999999999964e-01 3.980000000000000204e-01 1.099499999999999922e+00 8.685000000000000497e-01
7.000000000000000000e+00 2.571000000000000000e+03 -1.000000000000000000e+00 -1.000000000000000000e+00 -1.000000000000000000e+00 -1.000000000000000000e+00 -1.000000000000000000e+00 3.595199999999999818e+02 1.097990999999999985e+03 7.459999999999999964e-01 3.980000000000000204e-01 1.099499999999999922e+00 8.685000000000000497e-01
8.000000000000000000e+00 2.571000000000000000e+03 -1.000000000000000000e+00 -1.000000000000000000e+00 -1.000000000000000000e+00 -1.000000000000000000e+00 -1.000000000000000000e+00 3.592810000000000059e+02 1.099690000000000055e+03 7.459999999999999964e-01 3.980000000000000204e-01 1.099499999999999922e+00 8.685000000000000497e-01
9.000000000000000000e+00 2.571000000000000000e+03 -1.000000000000000000e+00 -1.000000000000000000e+00 -1.000000000000000000e+00 -1.000000000000000000e+00 -1.000000000000000000e+00 3.589549999999999841e+02 1.101118999999999915e+03 7.459999999999999964e-01 3.980000000000000204e-01 1.099499999999999922e+00 8.685000000000000497e-01
1.000000000000000000e+01 2.571000000000000000e+03 -1.000000000000000000e+00 -1.000000000000000000e+00 -1.000000000000000000e+00 -1.000000000000000000e+00 -1.000000000000000000e+00 3.585149999999999864e+02 1.102626999999999953e+03 7.459999999999999964e-01 3.980000000000000204e-01 1.099499999999999922e+00 8.685000000000000497e-01
1.100000000000000000e+01 2.571000000000000000e+03 -1.000000000000000000e+00 -1.000000000000000000e+00 -1.000000000000000000e+00 -1.000000000000000000e+00 -1.000000000000000000e+00 3.580740000000000123e+02 1.104134000000000015e+03 7.459999999999999964e-01 3.980000000000000204e-01 1.099499999999999922e+00 8.685000000000000497e-01
1.200000000000000000e+01 2.571000000000000000e+03 -1.000000000000000000e+00 -1.000000000000000000e+00 -1.000000000000000000e+00 -1.000000000000000000e+00 -1.000000000000000000e+00 3.576329999999999814e+02 1.105642000000000053e+03 7.459999999999999964e-01 3.980000000000000204e-01 1.099499999999999922e+00 8.685000000000000497e-01
1.300000000000000000e+01 2.571000000000000000e+03 -1.000000000000000000e+00 -1.000000000000000000e+00 -1.000000000000000000e+00 -1.000000000000000000e+00 -1.000000000000000000e+00 3.566770000000000209e+02 1.107769999999999982e+03 7.459999999999999964e-01 3.980000000000000204e-01 1.099499999999999922e+00 8.685000000000000497e-01
1.400000000000000000e+01 2.571000000000000000e+03 -1.000000000000000000e+00 -1.000000000000000000e+00 -1.000000000000000000e+00 -1.000000000000000000e+00 -1.000000000000000000e+00 3.559529999999999745e+02 1.109368999999999915e+03 7.459999999999999964e-01 3.980000000000000204e-01 1.099499999999999922e+00 8.685000000000000497e-01
1.500000000000000000e+01 2.571000000000000000e+03 -1.000000000000000000e+00 -1.000000000000000000e+00 -1.000000000000000000e+00 -1.000000000000000000e+00 -1.000000000000000000e+00 3.546960000000000264e+02 1.111395999999999958e+03 7.459999999999999964e-01 3.980000000000000204e-01 1.099499999999999922e+00 8.685000000000000497e-01
1.600000000000000000e+01 2.571000000000000000e+03 -1.000000000000000000e+00 -1.000000000000000000e+00 -1.000000000000000000e+00 -1.000000000000000000e+00 -1.000000000000000000e+00 3.529110000000000014e+02 1.113773999999999887e+03 7.960000000000000409e-01 3.980000000000000204e-01 1.099499999999999922e+00 8.685000000000000497e-01
1.700000000000000000e+01 2.571000000000000000e+03 -1.000000000000000000e+00 -1.000000000000000000e+00 -1.000000000000000000e+00 -1.000000000000000000e+00 -1.000000000000000000e+00 3.510000000000000000e+02 1.116051999999999907e+03 8.459999999999999742e-01 3.980000000000000204e-01 1.099499999999999922e+00 8.685000000000000497e-01
