8.000000000000000000e+00 1.899000000000000000e+03 -1.000000000000000000e+00 -1.000000000000000000e+00 -1.000000000000000000e+00 -1.000000000000000000e+00 -1.000000000000000000e+00 4.558310000000000173e+02 1.266304000000000087e+03 3.439999999999999725e-01 2.404999999999999916e-01 7.914999999999999813e-01 4.764999999999999791e-01
9.000000000000000000e+00 1.899000000000000000e+03 -1.000000000000000000e+00 -1.000000000000000000e+00 -1.000000000000000000e+00 -1.000000000000000000e+00 -1.000000000000000000e+00 4.558310000000000173e+02 1.266304000000000087e+03 3.860000000000000098e-01 2.404999999999999916e-01 7.914999999999999813e-01 4.764999999999999791e-01
1.000000000000000000e+01 1.899000000000000000e+03 -1.000000000000000000e+00 -1.000000000000000000e+00 -1.000000000000000000e+00 -1.000000000000000000e+00 -1.000000000000000000e+00 4.558310000000000173e+02 1.266304000000000087e+03 4.390000000000000013e-01 2.404999999999999916e-01 7.914999999999999813e-01 4.764999999999999791e-01
1.100000000000000000e+01 1.899000000000000000e+03 -1.000000000000000000e+00 -1.000000000000000000e+00 -1.000000000000000000e+00 -1.000000000000000000e+00 -1.000000000000000000e+00 4.558310000000000173e+02 1.266304000000000087e+03 4.909999999999999920e-01 2.404999999999999916e-01 7.914999999999999813e-01 4.764999999999999791e-01
1.200000000000000000e+01 1.899000000000000000e+03 -1.000000000000000000e+00 -1.000000000000000000e+00 -1.000000000000000000e+00 -1.000000000000000000e+00 -1.000000000000000000e+00 4.558310000000000173e+02 1.266304000000000087e+03 5.440000000000000391e-01 2.404999999999999916e-01 7.914999999999999813e-01 4.764999999999999791e-01
1.300000000000000000e+01 1.899000000000000000e+03 -1.000000000000000000e+00 -1.000000000000000000e+00 -1.000000000000000000e+00 -1.000000000000000000e+00 -1.000000000000000000e+00 4.558255020760377079e+02 1.266201738614301121e+03 5.440000000000000391e-01 2.404999999999999916e-01 7.914999999999999813e-01 4.764999999999999791e-01
1.400000000000000000e+01 1.899000000000000000e+03 -1.000000000000000000e+00 -1.000000000000000000e+00 -1.000000000000000000e+00 -1.000000000000000000e+00 -1.000000000000000000e+00 4.558210000000000264e+02 1.266117999999999938e+03 5.440000000000000391e-01 2.404999999999999916e-01 7.914999999999999813e-01 4.764999999999999791e-01
1.500000000000000000e+01 1.899000000000000000e+03 -1.000000000000000000e+00 -1.000000000000000000e+00 -1.000000000000000000e+00 -1.000000000000000000e+00 -1.000000000000000000e+00 4.558210000000000264e+02 1.266117999999999938e+03 5.939999999999999725e-01 2.404999999999999916e-01 7.914999999999999813e-01 4.764999999999999791e-01
1.600000000000000000e+01 1.899000000000000000e+03 -1.000000000000000000e+00 -1.000000000000000000e+00 -1.000000000000000000e+00 -1.000000000000000000e+00 -1.000000000000000000e+00 4.557950000000000159e+02 1.266201000000000022e+03 6.440000000000000169e-01 2.404999999999999916e-01 7.914999999999999813e-01 4.764999999999999791e-01
1.700000000000000000e+01 1.899000000000000000e+03 -1.000000000000000000e+00 -1.000000000000000000e+00 -1.000000000000000000e+00 -1.000000000000000000e+00 -1.000000000000000000e+00 4.557900000000000205e+02 1.266201000000000022e+03 6.889999999999999458e-01 2.404999999999999916e-01 7.914999999999999813e-01 4.764999999999999791e-01
1.800000000000000000e+01 1.899000000000000000e+03 -1.000000000000000000e+00 -1.000000000000000000e+00 -1.000000000000000000e+00 -1.000000000000000000e+00 -1.000000000000000000e+00 4.557869999999999777e+02 1.266201000000000022e+03 7.289999999999999813e-01 2.404999999999999916e-01 7.914999999999999813e-01 4.764999999999999791e-01
1.900000000000000000e+01 1.899000000000000000e+03 -1.000000000000000000e+00 -1.000000000000000000e+00 -1.000000000000000000e+00 -1.000000000000000000e+00 -1.000000000000000000e+00 4.557819999999999823e+02 1.266201000000000022e+03 7.790000000000000258e-01 2.404999999999999916e-01 7.914999999999999813e-01 4.764999999999999791e-01
2.000000000000000000e+01 1.899000000000000000e+03 -1.000000000000000000e+00 -1.000000000000000000e+00 -1.000000000000000000e+00 -1.000000000000000000e+00 -1.000000000000000000e+00 4.557769999999999868e+02 1.266201000000000022e+03 8.289999999999999591e-01 2.404999999999999916e-01 7.914999999999999813e-01 4.764999999999999791e-01
2.100000000000000000e+01 1.899000000000000000e+03 -1.000000000000000000e+00 -1.000000000000000000e+00 -1.000000000000000000e+00 -1.000000000000000000e+00 -1.000000000000000000e+00 4.557719999999999914e+02 1.266200000000000045e+03 8.790000000000000036e-01 2.404999999999999916e-01 7.914999999999999813e-01 4.764999999999999791e-01
2.200000000000000000e+01 1.899000000000000000e+03 -1.000000000000000000e+00 -1.000000000000000000e+00 -1.000000000000000000e+00 -1.000000000000000000e+00 -1.000000000000000000e+00 4.557719999999999914e+02 1.266200000000000045e+03 9.290000000000000480e-01 2.404999999999999916e-01 7.914999999999999813e-01 4.764999999999999791e-01
2.300000000000000000e+01 1.899000000000000000e+03 -1.000000000000000000e+00 -1.000000000000000000e+00 -1.000000000000000000e+00 -1.000000000000000000e+00 -1.000000000000000000e+00 4.557719999999999914e+02 1.266200000000000045e+03 9.789999999999999813e-01 2.404999999999999916e-01 7.914999999999999813e-01 4.764999999999999791e-01
