1.000000000000000000e+01 4.610000000000000000e+02 -1.000000000000000000e+00 -1.000000000000000000e+00 -1.000000000000000000e+00 -1.000000000000000000e+00 -1.000000000000000000e+00 9.583239999999999554e+02 6.581989999999999554e+02 1.215000000000000080e+00 4.154999999999999805e-01 3.119999999999999996e-01 8.129999999999999449e-01
1.000000000000000000e+01 4.620000000000000000e+02 -1.000000000000000000e+00 -1.000000000000000000e+00 -1.000000000000000000e+00 -1.000000000000000000e+00 -1.000000000000000000e+00 9.570380000000000109e+02 6.590689999999999600e+02 1.072999999999999954e+00 3.119999999999999996e-01 2.775000000000000244e-01 9.449999999999999512e-01
1.000000000000000000e+01 4.630000000000000000e+02 -1.000000000000000000e+00 -1.000000000000000000e+00 -1.000000000000000000e+00 -1.000000000000000000e+00 -1.000000000000000000e+00 9.567799999999999727e+02 6.549320000000000164e+02 1.334999999999999964e+00 2.600000000000000089e-01 2.775000000000000244e-01 7.694999999999999618e-01
1.100000000000000000e+01 4.610000000000000000e+02 -1.000000000000000000e+00 -1.000000000000000000e+00 -1.000000000000000000e+00 -1.000000000000000000e+00 -1.000000000000000000e+00 9.583440000000000509e+02 6.581689999999999827e+02 1.201000000000000068e+00 4.154999999999999805e-01 3.119999999999999996e-01 8.129999999999999449e-01
1.100000000000000000e+01 4.620000000000000000e+02 -1.000000000000000000e+00 -1.000000000000000000e+00 -1.000000000000000000e+00 -1.000000000000000000e+00 -1.000000000000000000e+00 9.570330000000000155e+02 6.590639999999999645e+02 1.022999999999999909e+00 3.119999999999999996e-01 2.775000000000000244e-01 9.449999999999999512e-01
1.100000000000000000e+01 4.630000000000000000e+02 -1.000000000000000000e+00 -1.000000000000000000e+00 -1.000000000000000000e+00 -1.000000000000000000e+00 -1.000000000000000000e+00 9.567780011396899909e+02 6.549245042738375560e+02 1.308515100892557292e+00 2.600000000000000089e-01 2.775000000000000244e-01 7.694999999999999618e-01
1.200000000000000000e+01 4.610000000000000000e+02 -1.000000000000000000e+00 -1.000000000000000000e+00 -1.000000000000000000e+00 -1.000000000000000000e+00 -1.000000000000000000e+00 9.583440000000000509e+02 6.581689999999999827e+02 1.264999999999999902e+00 4.154999999999999805e-01 3.119999999999999996e-01 8.129999999999999449e-01
1.200000000000000000e+01 4.630000000000000000e+02 -1.000000000000000000e+00 -1.000000000000000000e+00 -1.000000000000000000e+00 -1.000000000000000000e+00 -1.000000000000000000e+00 9.567759999999999536e+02 6.549170000000000300e+02 1.282000000000000028e+00 2.600000000000000089e-01 2.775000000000000244e-01 7.694999999999999618e-01
1.200000000000000000e+01 4.620000000000000000e+02 -1.000000000000000000e+00 -1.000000000000000000e+00 -1.000000000000000000e+00 -1.000000000000000000e+00 -1.000000000000000000e+00 9.570304998974736463e+02 6.590614998974735954e+02 1.022999999999999909e+00 3.119999999999999996e-01 2.775000000000000244e-01 9.449999999999999512e-01
1.300000000000000000e+01 4.610000000000000000e+02 -1.000000000000000000e+00 -1.000000000000000000e+00 -1.000000000000000000e+00 -1.000000000000000000e+00 -1.000000000000000000e+00 9.583289999999999509e+02 6.581539999999999964e+02 1.215000000000000080e+00 4.154999999999999805e-01 3.119999999999999996e-01 8.129999999999999449e-01
1.300000000000000000e+01 4.670000000000000000e+02 -1.000000000000000000e+00 -1.000000000000000000e+00 -1.000000000000000000e+00 -1.000000000000000000e+00 -1.000000000000000000e+00 9.573790000000000191e+02 6.585520000000000209e+02 1.254000000000000004e+00 3.355000000000000204e-01 3.114999999999999991e-01 9.244999999999999885e-01
1.300000000000000000e+01 4.680000000000000000e+02 -1.000000000000000000e+00 -1.000000000000000000e+00 -1.000000000000000000e+00 -1.000000000000000000e+00 -1.000000000000000000e+00 9.454239999999999782e+02 6.635689999999999600e+02 1.548999999999999932e+00 2.954999999999999849e-01 2.949999999999999845e-01 9.034999999999999698e-01
1.300000000000000000e+01 4.620000000000000000e+02 -1.000000000000000000e+00 -1.000000000000000000e+00 -1.000000000000000000e+00 -1.000000000000000000e+00 -1.000000000000000000e+00 9.570280000000000200e+02 6.590589999999999691e+02 1.022999999999999909e+00 3.119999999999999996e-01 2.775000000000000244e-01 9.449999999999999512e-01
1.300000000000000000e+01 4.630000000000000000e+02 -1.000000000000000000e+00 -1.000000000000000000e+00 -1.000000000000000000e+00 -1.000000000000000000e+00 -1.000000000000000000e+00 9.567749999999999773e+02 6.549099999999999682e+02 1.254999999999999893e+00 2.600000000000000089e-01 2.775000000000000244e-01 7.694999999999999618e-01
1.400000000000000000e+01 4.610000000000000000e+02 -1.000000000000000000e+00 -1.000000000000000000e+00 -1.000000000000000000e+00 -1.000000000000000000e+00 -1.000000000000000000e+00 9.583020000000000209e+02 6.581259999999999764e+02 1.215000000000000080e+00 4.154999999999999805e-01 3.119999999999999996e-01 8.129999999999999449e-01
1.400000000000000000e+01 4.670000000000000000e+02 -1.000000000000000000e+00 -1.000000000000000000e+00 -1.000000000000000000e+00 -1.000000000000000000e+00 -1.000000000000000000e+00 9.573849999999999909e+02 6.583890000000000100e+02 1.254000000000000004e+00 3.355000000000000204e-01 3.114999999999999991e-01 9.244999999999999885e-01
1.400000000000000000e+01 4.680000000000000000e+02 -1.000000000000000000e+00 -1.000000000000000000e+00 -1.000000000000000000e+00 -1.000000000000000000e+00 -1.000000000000000000e+00 9.454230000000000018e+02 6.635679999999999836e+02 1.514999999999999902e+00 2.954999999999999849e-01 2.949999999999999845e-01 9.034999999999999698e-01
1.400000000000000000e+01 4.620000000000000000e+02 -1.000000000000000000e+00 -1.000000000000000000e+00 -1.000000000000000000e+00 -1.000000000000000000e+00 -1.000000000000000000e+00 9.570330000000000155e+02 6.590639999999999645e+02 1.072999999999999954e+00 3.119999999999999996e-01 2.775000000000000244e-01 9.449999999999999512e-01
1.400000000000000000e+01 4.630000000000000000e+02 -1.000000000000000000e+00 -1.000000000000000000e+00 -1.000000000000000000e+00 -1.000000000000000000e+00 -1.000000000000000000e+00 9.567730000000000246e+02 6.549020000000000437e+02 1.227999999999999980e+00 2.600000000000000089e-01 2.775000000000000244e-01 7.694999999999999618e-01
1.500000000000000000e+01 4.610000000000000000e+02 -1.000000000000000000e+00 -1.000000000000000000e+00 -1.000000000000000000e+00 -1.000000000000000000e+00 -1.000000000000000000e+00 9.582210000000000036e+02 6.580639999999999645e+02 1.215000000000000080e+00 4.154999999999999805e-01 3.119999999999999996e-01 8.129999999999999449e-01
1.500000000000000000e+01 4.670000000000000000e+02 -1.000000000000000000e+00 -1.000000000000000000e+00 -1.000000000000000000e+00 -1.000000000000000000e+00 -1.000000000000000000e+00 9.572340000000000373e+02 6.583229999999999791e+02 1.203999999999999959e+00 3.355000000000000204e-01 3.114999999999999991e-01 9.244999999999999885e-01
1.500000000000000000e+01 4.680000000000000000e+02 -1.000000000000000000e+00 -1.000000000000000000e+00 -1.000000000000000000e+00 -1.000000000000000000e+00 -1.000000000000000000e+00 9.454339999999999691e+02 6.635099999999999909e+02 1.453000000000000069e+00 2.954999999999999849e-01 2.949999999999999845e-01 9.034999999999999698e-01
1.500000000000000000e+01 4.620000000000000000e+02 -1.000000000000000000e+00 -1.000000000000000000e+00 -1.000000000000000000e+00 -1.000000000000000000e+00 -1.000000000000000000e+00 9.570380000000000109e+02 6.590689999999999600e+02 1.072999999999999954e+00 3.119999999999999996e-01 2.775000000000000244e-01 9.449999999999999512e-01
1.500000000000000000e+01 4.630000000000000000e+02 -1.000000000000000000e+00 -1.000000000000000000e+00 -1.000000000000000000e+00 -1.000000000000000000e+00 -1.000000000000000000e+00 9.567709999999999582e+02 6.548949999999999818e+02 1.201000000000000068e+00 2.600000000000000089e-01 2.775000000000000244e-01 7.694999999999999618e-01
1.600000000000000000e+01 4.610000000000000000e+02 -1.000000000000000000e+00 -1.000000000000000000e+00 -1.000000000000000000e+00 -1.000000000000000000e+00 -1.000000000000000000e+00 9.581599999999999682e+02 6.580940000000000509e+02 1.165000000000000036e+00 4.154999999999999805e-01 3.119999999999999996e-01 8.129999999999999449e-01
1.600000000000000000e+01 4.670000000000000000e+02 -1.000000000000000000e+00 -1.000000000000000000e+00 -1.000000000000000000e+00 -1.000000000000000000e+00 -1.000000000000000000e+00 9.569239999999999782e+02 6.584729999999999563e+02 1.104000000000000092e+00 3.355000000000000204e-01 3.114999999999999991e-01 9.244999999999999885e-01
1.600000000000000000e+01 4.680000000000000000e+02 -1.000000000000000000e+00 -1.000000000000000000e+00 -1.000000000000000000e+00 -1.000000000000000000e+00 -1.000000000000000000e+00 9.454450000000000500e+02 6.634529999999999745e+02 1.389999999999999902e+00 2.954999999999999849e-01 2.949999999999999845e-01 9.034999999999999698e-01
1.600000000000000000e+01 4.620000000000000000e+02 -1.000000000000000000e+00 -1.000000000000000000e+00 -1.000000000000000000e+00 -1.000000000000000000e+00 -1.000000000000000000e+00 9.570420000000000300e+02 6.590739999999999554e+02 1.072999999999999954e+00 3.119999999999999996e-01 2.775000000000000244e-01 9.449999999999999512e-01
1.600000000000000000e+01 4.630000000000000000e+02 -1.000000000000000000e+00 -1.000000000000000000e+00 -1.000000000000000000e+00 -1.000000000000000000e+00 -1.000000000000000000e+00 9.567699999999999818e+02 6.548880000000000337e+02 1.173999999999999932e+00 2.600000000000000089e-01 2.775000000000000244e-01 7.694999999999999618e-01
1.700000000000000000e+01 4.610000000000000000e+02 -1.000000000000000000e+00 -1.000000000000000000e+00 -1.000000000000000000e+00 -1.000000000000000000e+00 -1.000000000000000000e+00 9.582190000000000509e+02 6.580750000000000455e+02 1.052000000000000046e+00 4.154999999999999805e-01 3.119999999999999996e-01 8.129999999999999449e-01
1.700000000000000000e+01 4.670000000000000000e+02 -1.000000000000000000e+00 -1.000000000000000000e+00 -1.000000000000000000e+00 -1.000000000000000000e+00 -1.000000000000000000e+00 9.566860000000000355e+02 6.586130000000000564e+02 1.104000000000000092e+00 3.355000000000000204e-01 3.114999999999999991e-01 9.244999999999999885e-01
1.700000000000000000e+01 4.680000000000000000e+02 -1.000000000000000000e+00 -1.000000000000000000e+00 -1.000000000000000000e+00 -1.000000000000000000e+00 -1.000000000000000000e+00 9.454550000000000409e+02 6.633959999999999582e+02 1.328000000000000069e+00 2.954999999999999849e-01 2.949999999999999845e-01 9.034999999999999698e-01
1.700000000000000000e+01 4.620000000000000000e+02 -1.000000000000000000e+00 -1.000000000000000000e+00 -1.000000000000000000e+00 -1.000000000000000000e+00 -1.000000000000000000e+00 9.570420000000000300e+02 6.590739999999999554e+02 1.072999999999999954e+00 3.119999999999999996e-01 2.775000000000000244e-01 9.449999999999999512e-01
1.700000000000000000e+01 4.630000000000000000e+02 -1.000000000000000000e+00 -1.000000000000000000e+00 -1.000000000000000000e+00 -1.000000000000000000e+00 -1.000000000000000000e+00 9.567680000000000291e+02 6.548799999999999955e+02 1.147000000000000020e+00 2.600000000000000089e-01 2.775000000000000244e-01 7.694999999999999618e-01
1.800000000000000000e+01 4.610000000000000000e+02 -1.000000000000000000e+00 -1.000000000000000000e+00 -1.000000000000000000e+00 -1.000000000000000000e+00 -1.000000000000000000e+00 9.582939999999999827e+02 6.581599999999999682e+02 1.032999999999999918e+00 4.154999999999999805e-01 3.119999999999999996e-01 8.129999999999999449e-01
1.800000000000000000e+01 4.670000000000000000e+02 -1.000000000000000000e+00 -1.000000000000000000e+00 -1.000000000000000000e+00 -1.000000000000000000e+00 -1.000000000000000000e+00 9.564700000000000273e+02 6.588289999999999509e+02 1.054000000000000048e+00 3.355000000000000204e-01 3.114999999999999991e-01 9.244999999999999885e-01
1.800000000000000000e+01 4.680000000000000000e+02 -1.000000000000000000e+00 -1.000000000000000000e+00 -1.000000000000000000e+00 -1.000000000000000000e+00 -1.000000000000000000e+00 9.454660000000000082e+02 6.633379999999999654e+02 1.264999999999999902e+00 2.954999999999999849e-01 2.949999999999999845e-01 9.034999999999999698e-01
1.800000000000000000e+01 4.620000000000000000e+02 -1.000000000000000000e+00 -1.000000000000000000e+00 -1.000000000000000000e+00 -1.000000000000000000e+00 -1.000000000000000000e+00 9.570539999999999736e+02 6.590059999999999718e+02 1.072999999999999954e+00 3.119999999999999996e-01 2.775000000000000244e-01 9.449999999999999512e-01
1.800000000000000000e+01 4.630000000000000000e+02 -1.000000000000000000e+00 -1.000000000000000000e+00 -1.000000000000000000e+00 -1.000000000000000000e+00 -1.000000000000000000e+00 9.567659999999999627e+02 6.548730000000000473e+02 1.120000000000000107e+00 2.600000000000000089e-01 2.775000000000000244e-01 7.694999999999999618e-01
1.900000000000000000e+01 4.610000000000000000e+02 -1.000000000000000000e+00 -1.000000000000000000e+00 -1.000000000000000000e+00 -1.000000000000000000e+00 -1.000000000000000000e+00 9.582889999999999873e+02 6.581649999999999636e+02 1.032999999999999918e+00 4.154999999999999805e-01 3.119999999999999996e-01 8.129999999999999449e-01
1.900000000000000000e+01 4.670000000000000000e+02 -1.000000000000000000e+00 -1.000000000000000000e+00 -1.000000000000000000e+00 -1.000000000000000000e+00 -1.000000000000000000e+00 9.564210000000000491e+02 6.591530000000000200e+02 1.054000000000000048e+00 3.355000000000000204e-01 3.114999999999999991e-01 9.244999999999999885e-01
1.900000000000000000e+01 4.680000000000000000e+02 -1.000000000000000000e+00 -1.000000000000000000e+00 -1.000000000000000000e+00 -1.000000000000000000e+00 -1.000000000000000000e+00 9.454660000000000082e+02 6.633379999999999654e+02 1.264999999999999902e+00 2.954999999999999849e-01 2.949999999999999845e-01 9.034999999999999698e-01
1.900000000000000000e+01 4.620000000000000000e+02 -1.000000000000000000e+00 -1.000000000000000000e+00 -1.000000000000000000e+00 -1.000000000000000000e+00 -1.000000000000000000e+00 9.570570000000000164e+02 6.590800000000000409e+02 1.072999999999999954e+00 3.119999999999999996e-01 2.775000000000000244e-01 9.449999999999999512e-01
1.900000000000000000e+01 4.630000000000000000e+02 -1.000000000000000000e+00 -1.000000000000000000e+00 -1.000000000000000000e+00 -1.000000000000000000e+00 -1.000000000000000000e+00 9.567640000000000100e+02 6.548650000000000091e+02 1.092999999999999972e+00 2.600000000000000089e-01 2.775000000000000244e-01 7.694999999999999618e-01
2.000000000000000000e+01 4.670000000000000000e+02 -1.000000000000000000e+00 -1.000000000000000000e+00 -1.000000000000000000e+00 -1.000000000000000000e+00 -1.000000000000000000e+00 9.561929999999999836e+02 6.595349999999999682e+02 1.054000000000000048e+00 3.355000000000000204e-01 3.114999999999999991e-01 9.244999999999999885e-01
2.000000000000000000e+01 4.680000000000000000e+02 -1.000000000000000000e+00 -1.000000000000000000e+00 -1.000000000000000000e+00 -1.000000000000000000e+00 -1.000000000000000000e+00 9.454660000000000082e+02 6.633379999999999654e+02 1.264999999999999902e+00 2.954999999999999849e-01 2.949999999999999845e-01 9.034999999999999698e-01
2.000000000000000000e+01 4.620000000000000000e+02 -1.000000000000000000e+00 -1.000000000000000000e+00 -1.000000000000000000e+00 -1.000000000000000000e+00 -1.000000000000000000e+00 9.570900000000000318e+02 6.591150000000000091e+02 1.072999999999999954e+00 3.119999999999999996e-01 2.775000000000000244e-01 9.449999999999999512e-01
2.000000000000000000e+01 4.610000000000000000e+02 -1.000000000000000000e+00 -1.000000000000000000e+00 -1.000000000000000000e+00 -1.000000000000000000e+00 -1.000000000000000000e+00 9.582684888185660839e+02 6.581499918184629223e+02 1.007986364104919819e+00 4.154999999999999805e-01 3.119999999999999996e-01 8.129999999999999449e-01
2.000000000000000000e+01 4.630000000000000000e+02 -1.000000000000000000e+00 -1.000000000000000000e+00 -1.000000000000000000e+00 -1.000000000000000000e+00 -1.000000000000000000e+00 9.567624991818462377e+02 6.548579961819493747e+02 1.065985273233313269e+00 2.600000000000000089e-01 2.775000000000000244e-01 7.694999999999999618e-01
2.100000000000000000e+01 4.610000000000000000e+02 -1.000000000000000000e+00 -1.000000000000000000e+00 -1.000000000000000000e+00 -1.000000000000000000e+00 -1.000000000000000000e+00 9.582480000000000473e+02 6.581349999999999909e+02 9.829999999999999849e-01 4.154999999999999805e-01 3.119999999999999996e-01 8.129999999999999449e-01
2.100000000000000000e+01 4.670000000000000000e+02 -1.000000000000000000e+00 -1.000000000000000000e+00 -1.000000000000000000e+00 -1.000000000000000000e+00 -1.000000000000000000e+00 9.562590000000000146e+02 6.597190000000000509e+02 1.054000000000000048e+00 3.355000000000000204e-01 3.114999999999999991e-01 9.244999999999999885e-01
2.100000000000000000e+01 4.680000000000000000e+02 -1.000000000000000000e+00 -1.000000000000000000e+00 -1.000000000000000000e+00 -1.000000000000000000e+00 -1.000000000000000000e+00 9.454660000000000082e+02 6.633379999999999654e+02 1.264999999999999902e+00 2.954999999999999849e-01 2.949999999999999845e-01 9.034999999999999698e-01
2.100000000000000000e+01 4.630000000000000000e+02 -1.000000000000000000e+00 -1.000000000000000000e+00 -1.000000000000000000e+00 -1.000000000000000000e+00 -1.000000000000000000e+00 9.567609999999999673e+02 6.548509999999999991e+02 1.038999999999999924e+00 2.600000000000000089e-01 2.775000000000000244e-01 7.694999999999999618e-01
2.100000000000000000e+01 4.620000000000000000e+02 -1.000000000000000000e+00 -1.000000000000000000e+00 -1.000000000000000000e+00 -1.000000000000000000e+00 -1.000000000000000000e+00 9.570874999574899675e+02 6.591124999574899448e+02 1.072999999999999954e+00 3.119999999999999996e-01 2.775000000000000244e-01 9.449999999999999512e-01
2.200000000000000000e+01 4.670000000000000000e+02 -1.000000000000000000e+00 -1.000000000000000000e+00 -1.000000000000000000e+00 -1.000000000000000000e+00 -1.000000000000000000e+00 9.562190000000000509e+02 6.597029999999999745e+02 1.054000000000000048e+00 3.355000000000000204e-01 3.114999999999999991e-01 9.244999999999999885e-01
2.200000000000000000e+01 4.620000000000000000e+02 -1.000000000000000000e+00 -1.000000000000000000e+00 -1.000000000000000000e+00 -1.000000000000000000e+00 -1.000000000000000000e+00 9.570850000000000364e+02 6.591100000000000136e+02 1.072999999999999954e+00 3.119999999999999996e-01 2.775000000000000244e-01 9.449999999999999512e-01
2.200000000000000000e+01 4.630000000000000000e+02 -1.000000000000000000e+00 -1.000000000000000000e+00 -1.000000000000000000e+00 -1.000000000000000000e+00 -1.000000000000000000e+00 9.567590000000000146e+02 6.548429999999999609e+02 1.012000000000000011e+00 2.600000000000000089e-01 2.775000000000000244e-01 7.694999999999999618e-01
2.200000000000000000e+01 4.680000000000000000e+02 -1.000000000000000000e+00 -1.000000000000000000e+00 -1.000000000000000000e+00 -1.000000000000000000e+00 -1.000000000000000000e+00 9.454151801605528362e+02 6.633176720642211421e+02 1.244672064221159724e+00 2.954999999999999849e-01 2.949999999999999845e-01 9.034999999999999698e-01
2.300000000000000000e+01 4.670000000000000000e+02 -1.000000000000000000e+00 -1.000000000000000000e+00 -1.000000000000000000e+00 -1.000000000000000000e+00 -1.000000000000000000e+00 9.562559999999999718e+02 6.596710000000000491e+02 1.054000000000000048e+00 3.355000000000000204e-01 3.114999999999999991e-01 9.244999999999999885e-01
2.300000000000000000e+01 4.680000000000000000e+02 -1.000000000000000000e+00 -1.000000000000000000e+00 -1.000000000000000000e+00 -1.000000000000000000e+00 -1.000000000000000000e+00 9.454393859093449919e+02 6.633273543637379817e+02 1.254354363738030553e+00 2.954999999999999849e-01 2.949999999999999845e-01 9.034999999999999698e-01
2.400000000000000000e+01 4.680000000000000000e+02 -1.000000000000000000e+00 -1.000000000000000000e+00 -1.000000000000000000e+00 -1.000000000000000000e+00 -1.000000000000000000e+00 9.453909999999999627e+02 6.633079999999999927e+02 1.235000000000000098e+00 2.954999999999999849e-01 2.949999999999999845e-01 9.034999999999999698e-01
2.500000000000000000e+01 4.680000000000000000e+02 -1.000000000000000000e+00 -1.000000000000000000e+00 -1.000000000000000000e+00 -1.000000000000000000e+00 -1.000000000000000000e+00 9.453659999999999854e+02 6.632980000000000018e+02 1.225000000000000089e+00 2.954999999999999849e-01 2.949999999999999845e-01 9.034999999999999698e-01
2.600000000000000000e+01 4.680000000000000000e+02 -1.000000000000000000e+00 -1.000000000000000000e+00 -1.000000000000000000e+00 -1.000000000000000000e+00 -1.000000000000000000e+00 9.453410000000000082e+02 6.632880000000000109e+02 1.215000000000000080e+00 2.954999999999999849e-01 2.949999999999999845e-01 9.034999999999999698e-01
2.700000000000000000e+01 4.680000000000000000e+02 -1.000000000000000000e+00 -1.000000000000000000e+00 -1.000000000000000000e+00 -1.000000000000000000e+00 -1.000000000000000000e+00 9.453410000000000082e+02 6.632880000000000109e+02 1.215000000000000080e+00 2.954999999999999849e-01 2.949999999999999845e-01 9.034999999999999698e-01
3.800000000000000000e+01 4.710000000000000000e+02 -1.000000000000000000e+00 -1.000000000000000000e+00 -1.000000000000000000e+00 -1.000000000000000000e+00 -1.000000000000000000e+00 9.326190000000000282e+02 7.533410000000000082e+02 1.155999999999999917e+00 3.744999999999999996e-01 3.775000000000000022e-01 7.039999999999999591e-01
3.800000000000000000e+01 4.720000000000000000e+02 -1.000000000000000000e+00 -1.000000000000000000e+00 -1.000000000000000000e+00 -1.000000000000000000e+00 -1.000000000000000000e+00 9.350639999999999645e+02 7.564070000000000391e+02 9.759999999999999787e-01 3.479999999999999760e-01 4.334999999999999964e-01 7.205000000000000293e-01
3.900000000000000000e+01 4.710000000000000000e+02 -1.000000000000000000e+00 -1.000000000000000000e+00 -1.000000000000000000e+00 -1.000000000000000000e+00 -1.000000000000000000e+00 9.326319999999999482e+02 7.533329999999999700e+02 1.151999999999999913e+00 3.744999999999999996e-01 3.775000000000000022e-01 7.039999999999999591e-01
3.900000000000000000e+01 4.720000000000000000e+02 -1.000000000000000000e+00 -1.000000000000000000e+00 -1.000000000000000000e+00 -1.000000000000000000e+00 -1.000000000000000000e+00 9.350639999999999645e+02 7.564070000000000391e+02 9.759999999999999787e-01 3.479999999999999760e-01 4.334999999999999964e-01 7.205000000000000293e-01
4.000000000000000000e+01 4.710000000000000000e+02 -1.000000000000000000e+00 -1.000000000000000000e+00 -1.000000000000000000e+00 -1.000000000000000000e+00 -1.000000000000000000e+00 9.326449999999999818e+02 7.533260000000000218e+02 1.147999999999999909e+00 3.744999999999999996e-01 3.775000000000000022e-01 7.039999999999999591e-01
4.000000000000000000e+01 4.720000000000000000e+02 -1.000000000000000000e+00 -1.000000000000000000e+00 -1.000000000000000000e+00 -1.000000000000000000e+00 -1.000000000000000000e+00 9.350629999999999882e+02 7.564070000000000391e+02 9.759999999999999787e-01 3.479999999999999760e-01 4.334999999999999964e-01 7.205000000000000293e-01
