1.000000000000000000e+00 4.550000000000000000e+02 -1.000000000000000000e+00 -1.000000000000000000e+00 -1.000000000000000000e+00 -1.000000000000000000e+00 -1.000000000000000000e+00 9.899940000000000282e+02 6.243479999999999563e+02 1.473999999999999977e+00 3.054999999999999938e-01 1.118000000000000105e+00 6.690000000000000391e-01
1.000000000000000000e+00 4.590000000000000000e+02 -1.000000000000000000e+00 -1.000000000000000000e+00 -1.000000000000000000e+00 -1.000000000000000000e+00 -1.000000000000000000e+00 9.863940000000000055e+02 6.273450000000000273e+02 1.538999999999999924e+00 2.605000000000000093e-01 1.047500000000000098e+00 6.270000000000000018e-01
2.000000000000000000e+00 4.550000000000000000e+02 -1.000000000000000000e+00 -1.000000000000000000e+00 -1.000000000000000000e+00 -1.000000000000000000e+00 -1.000000000000000000e+00 9.899940000000000282e+02 6.243479999999999563e+02 1.423999999999999932e+00 3.054999999999999938e-01 1.118000000000000105e+00 6.690000000000000391e-01
2.000000000000000000e+00 4.590000000000000000e+02 -1.000000000000000000e+00 -1.000000000000000000e+00 -1.000000000000000000e+00 -1.000000000000000000e+00 -1.000000000000000000e+00 9.864170000000000300e+02 6.273020000000000209e+02 1.455000000000000071e+00 2.605000000000000093e-01 1.047500000000000098e+00 6.270000000000000018e-01
3.000000000000000000e+00 4.550000000000000000e+02 -1.000000000000000000e+00 -1.000000000000000000e+00 -1.000000000000000000e+00 -1.000000000000000000e+00 -1.000000000000000000e+00 9.899940000000000282e+02 6.243479999999999563e+02 1.374000000000000110e+00 3.054999999999999938e-01 1.118000000000000105e+00 6.690000000000000391e-01
3.000000000000000000e+00 4.590000000000000000e+02 -1.000000000000000000e+00 -1.000000000000000000e+00 -1.000000000000000000e+00 -1.000000000000000000e+00 -1.000000000000000000e+00 9.864400000000000546e+02 6.272590000000000146e+02 1.372000000000000108e+00 2.605000000000000093e-01 1.047500000000000098e+00 6.270000000000000018e-01
4.000000000000000000e+00 4.550000000000000000e+02 -1.000000000000000000e+00 -1.000000000000000000e+00 -1.000000000000000000e+00 -1.000000000000000000e+00 -1.000000000000000000e+00 9.899940000000000282e+02 6.243479999999999563e+02 1.324000000000000066e+00 3.054999999999999938e-01 1.118000000000000105e+00 6.690000000000000391e-01
4.000000000000000000e+00 4.590000000000000000e+02 -1.000000000000000000e+00 -1.000000000000000000e+00 -1.000000000000000000e+00 -1.000000000000000000e+00 -1.000000000000000000e+00 9.864629999999999654e+02 6.272160000000000082e+02 1.288999999999999924e+00 2.605000000000000093e-01 1.047500000000000098e+00 6.270000000000000018e-01
5.000000000000000000e+00 4.550000000000000000e+02 -1.000000000000000000e+00 -1.000000000000000000e+00 -1.000000000000000000e+00 -1.000000000000000000e+00 -1.000000000000000000e+00 9.899940000000000282e+02 6.243479999999999563e+02 1.274000000000000021e+00 3.054999999999999938e-01 1.118000000000000105e+00 6.690000000000000391e-01
5.000000000000000000e+00 4.590000000000000000e+02 -1.000000000000000000e+00 -1.000000000000000000e+00 -1.000000000000000000e+00 -1.000000000000000000e+00 -1.000000000000000000e+00 9.864600000000000364e+02 6.272580000000000382e+02 1.254999999999999893e+00 2.605000000000000093e-01 1.047500000000000098e+00 6.270000000000000018e-01
6.000000000000000000e+00 4.550000000000000000e+02 -1.000000000000000000e+00 -1.000000000000000000e+00 -1.000000000000000000e+00 -1.000000000000000000e+00 -1.000000000000000000e+00 9.899940000000000282e+02 6.243479999999999563e+02 1.235999999999999988e+00 3.054999999999999938e-01 1.118000000000000105e+00 6.690000000000000391e-01
6.000000000000000000e+00 4.590000000000000000e+02 -1.000000000000000000e+00 -1.000000000000000000e+00 -1.000000000000000000e+00 -1.000000000000000000e+00 -1.000000000000000000e+00 9.864569999999999936e+02 6.272989999999999782e+02 1.221999999999999975e+00 2.605000000000000093e-01 1.047500000000000098e+00 6.270000000000000018e-01
7.000000000000000000e+00 4.550000000000000000e+02 -1.000000000000000000e+00 -1.000000000000000000e+00 -1.000000000000000000e+00 -1.000000000000000000e+00 -1.000000000000000000e+00 9.899940000000000282e+02 6.243479999999999563e+02 1.199000000000000066e+00 3.054999999999999938e-01 1.118000000000000105e+00 6.690000000000000391e-01
7.000000000000000000e+00 4.590000000000000000e+02 -1.000000000000000000e+00 -1.000000000000000000e+00 -1.000000000000000000e+00 -1.000000000000000000e+00 -1.000000000000000000e+00 9.864539999999999509e+02 6.273410000000000082e+02 1.189000000000000057e+00 2.605000000000000093e-01 1.047500000000000098e+00 6.270000000000000018e-01
8.000000000000000000e+00 4.550000000000000000e+02 -1.000000000000000000e+00 -1.000000000000000000e+00 -1.000000000000000000e+00 -1.000000000000000000e+00 -1.000000000000000000e+00 9.899940000000000282e+02 6.243479999999999563e+02 1.161000000000000032e+00 3.054999999999999938e-01 1.118000000000000105e+00 6.690000000000000391e-01
8.000000000000000000e+00 4.590000000000000000e+02 -1.000000000000000000e+00 -1.000000000000000000e+00 -1.000000000000000000e+00 -1.000000000000000000e+00 -1.000000000000000000e+00 9.864710000000000036e+02 6.272949999999999591e+02 1.088999999999999968e+00 2.605000000000000093e-01 1.047500000000000098e+00 6.270000000000000018e-01
9.000000000000000000e+00 4.550000000000000000e+02 -1.000000000000000000e+00 -1.000000000000000000e+00 -1.000000000000000000e+00 -1.000000000000000000e+00 -1.000000000000000000e+00 9.899940000000000282e+02 6.243479999999999563e+02 1.124000000000000110e+00 3.054999999999999938e-01 1.118000000000000105e+00 6.690000000000000391e-01
9.000000000000000000e+00 4.590000000000000000e+02 -1.000000000000000000e+00 -1.000000000000000000e+00 -1.000000000000000000e+00 -1.000000000000000000e+00 -1.000000000000000000e+00 9.864650000000000318e+02 6.272989999999999782e+02 1.100999999999999979e+00 2.605000000000000093e-01 1.047500000000000098e+00 6.270000000000000018e-01
1.000000000000000000e+01 4.550000000000000000e+02 -1.000000000000000000e+00 -1.000000000000000000e+00 -1.000000000000000000e+00 -1.000000000000000000e+00 -1.000000000000000000e+00 9.899940000000000282e+02 6.243479999999999563e+02 1.133999999999999897e+00 3.054999999999999938e-01 1.118000000000000105e+00 6.690000000000000391e-01
1.000000000000000000e+01 4.590000000000000000e+02 -1.000000000000000000e+00 -1.000000000000000000e+00 -1.000000000000000000e+00 -1.000000000000000000e+00 -1.000000000000000000e+00 9.864589999999999463e+02 6.273029999999999973e+02 1.114000000000000101e+00 2.605000000000000093e-01 1.047500000000000098e+00 6.270000000000000018e-01
1.100000000000000000e+01 4.640000000000000000e+02 -1.000000000000000000e+00 -1.000000000000000000e+00 -1.000000000000000000e+00 -1.000000000000000000e+00 -1.000000000000000000e+00 9.638070000000000164e+02 6.487820000000000391e+02 1.100000000000000089e+00 3.180000000000000049e-01 9.945000000000000506e-01 5.955000000000000293e-01
1.100000000000000000e+01 4.590000000000000000e+02 -1.000000000000000000e+00 -1.000000000000000000e+00 -1.000000000000000000e+00 -1.000000000000000000e+00 -1.000000000000000000e+00 9.864529999999999745e+02 6.273070000000000164e+02 1.125999999999999890e+00 2.605000000000000093e-01 1.047500000000000098e+00 6.270000000000000018e-01
1.100000000000000000e+01 4.550000000000000000e+02 -1.000000000000000000e+00 -1.000000000000000000e+00 -1.000000000000000000e+00 -1.000000000000000000e+00 -1.000000000000000000e+00 9.899940000000000282e+02 6.243479999999999563e+02 1.143994301549978276e+00 3.054999999999999938e-01 1.118000000000000105e+00 6.690000000000000391e-01
1.200000000000000000e+01 4.550000000000000000e+02 -1.000000000000000000e+00 -1.000000000000000000e+00 -1.000000000000000000e+00 -1.000000000000000000e+00 -1.000000000000000000e+00 9.899940000000000282e+02 6.243479999999999563e+02 1.153999999999999915e+00 3.054999999999999938e-01 1.118000000000000105e+00 6.690000000000000391e-01
1.200000000000000000e+01 4.640000000000000000e+02 -1.000000000000000000e+00 -1.000000000000000000e+00 -1.000000000000000000e+00 -1.000000000000000000e+00 -1.000000000000000000e+00 9.638139999999999645e+02 6.487770000000000437e+02 1.076000000000000068e+00 3.180000000000000049e-01 9.945000000000000506e-01 5.955000000000000293e-01
1.200000000000000000e+01 4.590000000000000000e+02 -1.000000000000000000e+00 -1.000000000000000000e+00 -1.000000000000000000e+00 -1.000000000000000000e+00 -1.000000000000000000e+00 9.864470000000000027e+02 6.273110000000000355e+02 1.139000000000000012e+00 2.605000000000000093e-01 1.047500000000000098e+00 6.270000000000000018e-01
1.300000000000000000e+01 4.550000000000000000e+02 -1.000000000000000000e+00 -1.000000000000000000e+00 -1.000000000000000000e+00 -1.000000000000000000e+00 -1.000000000000000000e+00 9.899940000000000282e+02 6.243479999999999563e+02 1.213999999999999968e+00 3.054999999999999938e-01 1.118000000000000105e+00 6.690000000000000391e-01
1.300000000000000000e+01 4.640000000000000000e+02 -1.000000000000000000e+00 -1.000000000000000000e+00 -1.000000000000000000e+00 -1.000000000000000000e+00 -1.000000000000000000e+00 9.638220000000000027e+02 6.487709999999999582e+02 1.050999999999999934e+00 3.180000000000000049e-01 9.945000000000000506e-01 5.955000000000000293e-01
1.300000000000000000e+01 4.590000000000000000e+02 -1.000000000000000000e+00 -1.000000000000000000e+00 -1.000000000000000000e+00 -1.000000000000000000e+00 -1.000000000000000000e+00 9.864469999999998890e+02 6.273110000000000355e+02 1.139000000000000012e+00 2.605000000000000093e-01 1.047500000000000098e+00 6.270000000000000018e-01
1.400000000000000000e+01 4.550000000000000000e+02 -1.000000000000000000e+00 -1.000000000000000000e+00 -1.000000000000000000e+00 -1.000000000000000000e+00 -1.000000000000000000e+00 9.899940000000000282e+02 6.243479999999999563e+02 1.274000000000000021e+00 3.054999999999999938e-01 1.118000000000000105e+00 6.690000000000000391e-01
1.400000000000000000e+01 4.640000000000000000e+02 -1.000000000000000000e+00 -1.000000000000000000e+00 -1.000000000000000000e+00 -1.000000000000000000e+00 -1.000000000000000000e+00 9.638300000000000409e+02 6.487649999999999864e+02 1.026999999999999913e+00 3.180000000000000049e-01 9.945000000000000506e-01 5.955000000000000293e-01
1.400000000000000000e+01 4.590000000000000000e+02 -1.000000000000000000e+00 -1.000000000000000000e+00 -1.000000000000000000e+00 -1.000000000000000000e+00 -1.000000000000000000e+00 9.864470000000000027e+02 6.273110000000000355e+02 1.139000000000000012e+00 2.605000000000000093e-01 1.047500000000000098e+00 6.270000000000000018e-01
1.500000000000000000e+01 4.640000000000000000e+02 -1.000000000000000000e+00 -1.000000000000000000e+00 -1.000000000000000000e+00 -1.000000000000000000e+00 -1.000000000000000000e+00 9.638379999999999654e+02 6.487590000000000146e+02 1.002000000000000002e+00 3.180000000000000049e-01 9.945000000000000506e-01 5.955000000000000293e-01
1.500000000000000000e+01 4.590000000000000000e+02 -1.000000000000000000e+00 -1.000000000000000000e+00 -1.000000000000000000e+00 -1.000000000000000000e+00 -1.000000000000000000e+00 9.864470000000000027e+02 6.273110000000000355e+02 1.139000000000000012e+00 2.605000000000000093e-01 1.047500000000000098e+00 6.270000000000000018e-01
1.600000000000000000e+01 4.640000000000000000e+02 -1.000000000000000000e+00 -1.000000000000000000e+00 -1.000000000000000000e+00 -1.000000000000000000e+00 -1.000000000000000000e+00 9.638460000000000036e+02 6.487530000000000427e+02 9.779999999999999805e-01 3.180000000000000049e-01 9.945000000000000506e-01 5.955000000000000293e-01
1.600000000000000000e+01 4.590000000000000000e+02 -1.000000000000000000e+00 -1.000000000000000000e+00 -1.000000000000000000e+00 -1.000000000000000000e+00 -1.000000000000000000e+00 9.863440000000000509e+02 6.273010000000000446e+02 1.072999999999999954e+00 2.605000000000000093e-01 1.047500000000000098e+00 6.270000000000000018e-01
1.700000000000000000e+01 4.640000000000000000e+02 -1.000000000000000000e+00 -1.000000000000000000e+00 -1.000000000000000000e+00 -1.000000000000000000e+00 -1.000000000000000000e+00 9.638540000000000418e+02 6.487469999999999573e+02 9.529999999999999583e-01 3.180000000000000049e-01 9.945000000000000506e-01 5.955000000000000293e-01
1.700000000000000000e+01 4.590000000000000000e+02 -1.000000000000000000e+00 -1.000000000000000000e+00 -1.000000000000000000e+00 -1.000000000000000000e+00 -1.000000000000000000e+00 9.862419999999999618e+02 6.272920000000000300e+02 1.008000000000000007e+00 2.605000000000000093e-01 1.047500000000000098e+00 6.270000000000000018e-01
1.800000000000000000e+01 4.640000000000000000e+02 -1.000000000000000000e+00 -1.000000000000000000e+00 -1.000000000000000000e+00 -1.000000000000000000e+00 -1.000000000000000000e+00 9.638619999999999663e+02 6.487409999999999854e+02 9.290000000000000480e-01 3.180000000000000049e-01 9.945000000000000506e-01 5.955000000000000293e-01
1.800000000000000000e+01 4.590000000000000000e+02 -1.000000000000000000e+00 -1.000000000000000000e+00 -1.000000000000000000e+00 -1.000000000000000000e+00 -1.000000000000000000e+00 9.861390000000000100e+02 6.272830000000000155e+02 9.429999999999999494e-01 2.605000000000000093e-01 1.047500000000000098e+00 6.270000000000000018e-01
1.900000000000000000e+01 4.640000000000000000e+02 -1.000000000000000000e+00 -1.000000000000000000e+00 -1.000000000000000000e+00 -1.000000000000000000e+00 -1.000000000000000000e+00 9.638700000000000045e+02 6.487359999999999900e+02 9.040000000000000258e-01 3.180000000000000049e-01 9.945000000000000506e-01 5.955000000000000293e-01
2.000000000000000000e+01 4.640000000000000000e+02 -1.000000000000000000e+00 -1.000000000000000000e+00 -1.000000000000000000e+00 -1.000000000000000000e+00 -1.000000000000000000e+00 9.638780000000000427e+02 6.487300000000000182e+02 8.800000000000000044e-01 3.180000000000000049e-01 9.945000000000000506e-01 5.955000000000000293e-01
