1.000000000000000000e+00 3.154000000000000000e+03 -1.000000000000000000e+00 -1.000000000000000000e+00 -1.000000000000000000e+00 -1.000000000000000000e+00 -1.000000000000000000e+00 1.308987000000000080e+03 1.052605999999999995e+03 1.401999999999999913e+00 2.625000000000000111e-01 8.110000000000000542e-01 8.479999999999999760e-01
2.000000000000000000e+00 3.154000000000000000e+03 -1.000000000000000000e+00 -1.000000000000000000e+00 -1.000000000000000000e+00 -1.000000000000000000e+00 -1.000000000000000000e+00 1.310095000000000027e+03 1.053914999999999964e+03 1.502000000000000002e+00 2.625000000000000111e-01 8.110000000000000542e-01 8.479999999999999760e-01
3.000000000000000000e+00 3.154000000000000000e+03 -1.000000000000000000e+00 -1.000000000000000000e+00 -1.000000000000000000e+00 -1.000000000000000000e+00 -1.000000000000000000e+00 1.311244999999999891e+03 1.055224999999999909e+03 1.598000000000000087e+00 2.625000000000000111e-01 8.110000000000000542e-01 8.479999999999999760e-01
4.000000000000000000e+00 3.154000000000000000e+03 -1.000000000000000000e+00 -1.000000000000000000e+00 -1.000000000000000000e+00 -1.000000000000000000e+00 -1.000000000000000000e+00 1.312377999999999929e+03 1.056412000000000035e+03 1.693000000000000060e+00 2.625000000000000111e-01 8.110000000000000542e-01 8.479999999999999760e-01
5.000000000000000000e+00 3.154000000000000000e+03 -1.000000000000000000e+00 -1.000000000000000000e+00 -1.000000000000000000e+00 -1.000000000000000000e+00 -1.000000000000000000e+00 1.313544000000000096e+03 1.057577999999999975e+03 1.762999999999999901e+00 2.625000000000000111e-01 8.110000000000000542e-01 8.479999999999999760e-01
6.000000000000000000e+00 3.154000000000000000e+03 -1.000000000000000000e+00 -1.000000000000000000e+00 -1.000000000000000000e+00 -1.000000000000000000e+00 -1.000000000000000000e+00 1.314711000000000013e+03 1.058743999999999915e+03 1.834000000000000075e+00 2.625000000000000111e-01 8.110000000000000542e-01 8.479999999999999760e-01
7.000000000000000000e+00 3.154000000000000000e+03 -1.000000000000000000e+00 -1.000000000000000000e+00 -1.000000000000000000e+00 -1.000000000000000000e+00 -1.000000000000000000e+00 1.315878999999999905e+03 1.059912000000000035e+03 1.903999999999999915e+00 2.625000000000000111e-01 8.110000000000000542e-01 8.479999999999999760e-01
8.000000000000000000e+00 3.154000000000000000e+03 -1.000000000000000000e+00 -1.000000000000000000e+00 -1.000000000000000000e+00 -1.000000000000000000e+00 -1.000000000000000000e+00 1.316906999999999925e+03 1.061161000000000058e+03 1.975000000000000089e+00 2.625000000000000111e-01 8.110000000000000542e-01 8.479999999999999760e-01
9.000000000000000000e+00 3.154000000000000000e+03 -1.000000000000000000e+00 -1.000000000000000000e+00 -1.000000000000000000e+00 -1.000000000000000000e+00 -1.000000000000000000e+00 1.318086000000000013e+03 1.062365000000000009e+03 2.069999999999999840e+00 2.625000000000000111e-01 8.110000000000000542e-01 8.479999999999999760e-01
1.000000000000000000e+01 3.154000000000000000e+03 -1.000000000000000000e+00 -1.000000000000000000e+00 -1.000000000000000000e+00 -1.000000000000000000e+00 -1.000000000000000000e+00 1.319223999999999933e+03 1.063576999999999998e+03 2.165999999999999925e+00 2.625000000000000111e-01 8.110000000000000542e-01 8.479999999999999760e-01
1.100000000000000000e+01 3.154000000000000000e+03 -1.000000000000000000e+00 -1.000000000000000000e+00 -1.000000000000000000e+00 -1.000000000000000000e+00 -1.000000000000000000e+00 1.322785068140001840e+03 1.067208554643510070e+03 2.339966689509459741e+00 2.625000000000000111e-01 8.110000000000000542e-01 8.479999999999999760e-01
1.200000000000000000e+01 3.154000000000000000e+03 -1.000000000000000000e+00 -1.000000000000000000e+00 -1.000000000000000000e+00 -1.000000000000000000e+00 -1.000000000000000000e+00 1.321598515429381905e+03 1.065998515734785542e+03 2.282000753762187806e+00 2.625000000000000111e-01 8.110000000000000542e-01 8.479999999999999760e-01
1.300000000000000000e+01 3.154000000000000000e+03 -1.000000000000000000e+00 -1.000000000000000000e+00 -1.000000000000000000e+00 -1.000000000000000000e+00 -1.000000000000000000e+00 1.320411922364993870e+03 1.064788435673545109e+03 2.224032846636886163e+00 2.625000000000000111e-01 8.110000000000000542e-01 8.479999999999999760e-01
1.400000000000000000e+01 3.154000000000000000e+03 -1.000000000000000000e+00 -1.000000000000000000e+00 -1.000000000000000000e+00 -1.000000000000000000e+00 -1.000000000000000000e+00 1.323972999999999956e+03 1.068420000000000073e+03 2.398000000000000131e+00 2.625000000000000111e-01 8.110000000000000542e-01 8.479999999999999760e-01
1.500000000000000000e+01 3.154000000000000000e+03 -1.000000000000000000e+00 -1.000000000000000000e+00 -1.000000000000000000e+00 -1.000000000000000000e+00 -1.000000000000000000e+00 1.325028999999999996e+03 1.069803000000000111e+03 2.443000000000000060e+00 2.625000000000000111e-01 8.110000000000000542e-01 8.479999999999999760e-01
1.600000000000000000e+01 3.154000000000000000e+03 -1.000000000000000000e+00 -1.000000000000000000e+00 -1.000000000000000000e+00 -1.000000000000000000e+00 -1.000000000000000000e+00 1.325873000000000047e+03 1.070910000000000082e+03 2.479000000000000092e+00 2.625000000000000111e-01 8.110000000000000542e-01 8.479999999999999760e-01
1.700000000000000000e+01 3.154000000000000000e+03 -1.000000000000000000e+00 -1.000000000000000000e+00 -1.000000000000000000e+00 -1.000000000000000000e+00 -1.000000000000000000e+00 1.326969000000000051e+03 1.072544000000000096e+03 2.725000000000000089e+00 2.625000000000000111e-01 8.110000000000000542e-01 8.479999999999999760e-01
