7.000000000000000000e+00 4.000000000000000000e+01 -1.000000000000000000e+00 -1.000000000000000000e+00 -1.000000000000000000e+00 -1.000000000000000000e+00 -1.000000000000000000e+00 1.196290999999999940e+03 4.671850000000000023e+02 2.940999999999999837e+00 8.485000000000000320e-01 2.061999999999999833e+00 8.235000000000000098e-01
8.000000000000000000e+00 4.000000000000000000e+01 -1.000000000000000000e+00 -1.000000000000000000e+00 -1.000000000000000000e+00 -1.000000000000000000e+00 -1.000000000000000000e+00 1.196193999999999960e+03 4.671200000000000045e+02 2.734999999999999876e+00 8.485000000000000320e-01 2.061999999999999833e+00 8.235000000000000098e-01
8.000000000000000000e+00 4.200000000000000000e+01 -1.000000000000000000e+00 -1.000000000000000000e+00 -1.000000000000000000e+00 -1.000000000000000000e+00 -1.000000000000000000e+00 1.197111000000000104e+03 4.728809999999999718e+02 2.657000000000000028e+00 8.435000000000000275e-01 2.246500000000000163e+00 8.209999999999999520e-01
9.000000000000000000e+00 4.000000000000000000e+01 -1.000000000000000000e+00 -1.000000000000000000e+00 -1.000000000000000000e+00 -1.000000000000000000e+00 -1.000000000000000000e+00 1.196269999999999982e+03 4.671589999999999918e+02 2.563000000000000167e+00 8.485000000000000320e-01 2.061999999999999833e+00 8.235000000000000098e-01
9.000000000000000000e+00 4.200000000000000000e+01 -1.000000000000000000e+00 -1.000000000000000000e+00 -1.000000000000000000e+00 -1.000000000000000000e+00 -1.000000000000000000e+00 1.197099999999999909e+03 4.728530000000000086e+02 2.507000000000000117e+00 8.435000000000000275e-01 2.246500000000000163e+00 8.209999999999999520e-01
1.000000000000000000e+01 4.000000000000000000e+01 -1.000000000000000000e+00 -1.000000000000000000e+00 -1.000000000000000000e+00 -1.000000000000000000e+00 -1.000000000000000000e+00 1.196180000000000064e+03 4.672400000000000091e+02 2.315999999999999837e+00 8.485000000000000320e-01 2.061999999999999833e+00 8.235000000000000098e-01
1.000000000000000000e+01 4.200000000000000000e+01 -1.000000000000000000e+00 -1.000000000000000000e+00 -1.000000000000000000e+00 -1.000000000000000000e+00 -1.000000000000000000e+00 1.197041999999999916e+03 4.728740000000000236e+02 2.257000000000000117e+00 8.435000000000000275e-01 2.246500000000000163e+00 8.209999999999999520e-01
1.100000000000000000e+01 4.000000000000000000e+01 -1.000000000000000000e+00 -1.000000000000000000e+00 -1.000000000000000000e+00 -1.000000000000000000e+00 -1.000000000000000000e+00 1.196098999999999933e+03 4.672130000000000223e+02 1.989000000000000101e+00 8.485000000000000320e-01 2.061999999999999833e+00 8.235000000000000098e-01
1.100000000000000000e+01 4.200000000000000000e+01 -1.000000000000000000e+00 -1.000000000000000000e+00 -1.000000000000000000e+00 -1.000000000000000000e+00 -1.000000000000000000e+00 1.196961999999999989e+03 4.728380000000000223e+02 2.007000000000000117e+00 8.435000000000000275e-01 2.246500000000000163e+00 8.209999999999999520e-01
1.200000000000000000e+01 4.000000000000000000e+01 -1.000000000000000000e+00 -1.000000000000000000e+00 -1.000000000000000000e+00 -1.000000000000000000e+00 -1.000000000000000000e+00 1.196010999999999967e+03 4.672749999999999773e+02 1.987000000000000099e+00 8.485000000000000320e-01 2.061999999999999833e+00 8.235000000000000098e-01
1.200000000000000000e+01 4.200000000000000000e+01 -1.000000000000000000e+00 -1.000000000000000000e+00 -1.000000000000000000e+00 -1.000000000000000000e+00 -1.000000000000000000e+00 1.196854000000000042e+03 4.728120000000000118e+02 1.957000000000000073e+00 8.435000000000000275e-01 2.246500000000000163e+00 8.209999999999999520e-01
1.300000000000000000e+01 4.000000000000000000e+01 -1.000000000000000000e+00 -1.000000000000000000e+00 -1.000000000000000000e+00 -1.000000000000000000e+00 -1.000000000000000000e+00 1.195883000000000038e+03 4.671809999999999832e+02 1.834999999999999964e+00 8.485000000000000320e-01 2.061999999999999833e+00 8.235000000000000098e-01
1.300000000000000000e+01 4.200000000000000000e+01 -1.000000000000000000e+00 -1.000000000000000000e+00 -1.000000000000000000e+00 -1.000000000000000000e+00 -1.000000000000000000e+00 1.196796000000000049e+03 4.728340000000000032e+02 1.806999999999999940e+00 8.435000000000000275e-01 2.246500000000000163e+00 8.209999999999999520e-01
1.300000000000000000e+01 4.300000000000000000e+01 -1.000000000000000000e+00 -1.000000000000000000e+00 -1.000000000000000000e+00 -1.000000000000000000e+00 -1.000000000000000000e+00 1.197512999999999920e+03 4.701850000000000023e+02 1.808000000000000052e+00 8.415000000000000258e-01 2.059499999999999886e+00 7.740000000000000213e-01
1.400000000000000000e+01 4.000000000000000000e+01 -1.000000000000000000e+00 -1.000000000000000000e+00 -1.000000000000000000e+00 -1.000000000000000000e+00 -1.000000000000000000e+00 1.195882000000000062e+03 4.671999999999999886e+02 1.739999999999999991e+00 8.485000000000000320e-01 2.061999999999999833e+00 8.235000000000000098e-01
1.400000000000000000e+01 4.200000000000000000e+01 -1.000000000000000000e+00 -1.000000000000000000e+00 -1.000000000000000000e+00 -1.000000000000000000e+00 -1.000000000000000000e+00 1.196698000000000093e+03 4.728380000000000223e+02 1.657000000000000028e+00 8.435000000000000275e-01 2.246500000000000163e+00 8.209999999999999520e-01
1.400000000000000000e+01 4.300000000000000000e+01 -1.000000000000000000e+00 -1.000000000000000000e+00 -1.000000000000000000e+00 -1.000000000000000000e+00 -1.000000000000000000e+00 1.197400000000000091e+03 4.699870000000000232e+02 1.703999999999999959e+00 8.415000000000000258e-01 2.059499999999999886e+00 7.740000000000000213e-01
1.500000000000000000e+01 4.000000000000000000e+01 -1.000000000000000000e+00 -1.000000000000000000e+00 -1.000000000000000000e+00 -1.000000000000000000e+00 -1.000000000000000000e+00 1.195806000000000040e+03 4.671399999999999864e+02 1.594000000000000083e+00 8.485000000000000320e-01 2.061999999999999833e+00 8.235000000000000098e-01
1.500000000000000000e+01 4.200000000000000000e+01 -1.000000000000000000e+00 -1.000000000000000000e+00 -1.000000000000000000e+00 -1.000000000000000000e+00 -1.000000000000000000e+00 1.196705999999999904e+03 4.727690000000000055e+02 1.556999999999999940e+00 8.435000000000000275e-01 2.246500000000000163e+00 8.209999999999999520e-01
1.500000000000000000e+01 4.300000000000000000e+01 -1.000000000000000000e+00 -1.000000000000000000e+00 -1.000000000000000000e+00 -1.000000000000000000e+00 -1.000000000000000000e+00 1.197287000000000035e+03 4.697889999999999873e+02 1.600000000000000089e+00 8.415000000000000258e-01 2.059499999999999886e+00 7.740000000000000213e-01
1.600000000000000000e+01 4.000000000000000000e+01 -1.000000000000000000e+00 -1.000000000000000000e+00 -1.000000000000000000e+00 -1.000000000000000000e+00 -1.000000000000000000e+00 1.195820999999999913e+03 4.670489999999999782e+02 1.393000000000000016e+00 8.485000000000000320e-01 2.061999999999999833e+00 8.235000000000000098e-01
1.600000000000000000e+01 4.200000000000000000e+01 -1.000000000000000000e+00 -1.000000000000000000e+00 -1.000000000000000000e+00 -1.000000000000000000e+00 -1.000000000000000000e+00 1.196720000000000027e+03 4.726309999999999718e+02 1.457000000000000073e+00 8.435000000000000275e-01 2.246500000000000163e+00 8.209999999999999520e-01
1.600000000000000000e+01 4.300000000000000000e+01 -1.000000000000000000e+00 -1.000000000000000000e+00 -1.000000000000000000e+00 -1.000000000000000000e+00 -1.000000000000000000e+00 1.197298999999999978e+03 4.696480000000000246e+02 1.429000000000000048e+00 8.415000000000000258e-01 2.059499999999999886e+00 7.740000000000000213e-01
1.700000000000000000e+01 4.000000000000000000e+01 -1.000000000000000000e+00 -1.000000000000000000e+00 -1.000000000000000000e+00 -1.000000000000000000e+00 -1.000000000000000000e+00 1.195829999999999927e+03 4.670149999999999864e+02 1.296999999999999931e+00 8.485000000000000320e-01 2.061999999999999833e+00 8.235000000000000098e-01
1.700000000000000000e+01 4.200000000000000000e+01 -1.000000000000000000e+00 -1.000000000000000000e+00 -1.000000000000000000e+00 -1.000000000000000000e+00 -1.000000000000000000e+00 1.196724999999999909e+03 4.725059999999999718e+02 1.256999999999999895e+00 8.435000000000000275e-01 2.246500000000000163e+00 8.209999999999999520e-01
1.700000000000000000e+01 4.300000000000000000e+01 -1.000000000000000000e+00 -1.000000000000000000e+00 -1.000000000000000000e+00 -1.000000000000000000e+00 -1.000000000000000000e+00 1.197310999999999922e+03 4.695059999999999718e+02 1.258000000000000007e+00 8.415000000000000258e-01 2.059499999999999886e+00 7.740000000000000213e-01
1.800000000000000000e+01 4.000000000000000000e+01 -1.000000000000000000e+00 -1.000000000000000000e+00 -1.000000000000000000e+00 -1.000000000000000000e+00 -1.000000000000000000e+00 1.195830999999999904e+03 4.670439999999999827e+02 1.151000000000000023e+00 8.485000000000000320e-01 2.061999999999999833e+00 8.235000000000000098e-01
1.800000000000000000e+01 4.200000000000000000e+01 -1.000000000000000000e+00 -1.000000000000000000e+00 -1.000000000000000000e+00 -1.000000000000000000e+00 -1.000000000000000000e+00 1.196718000000000075e+03 4.725000000000000000e+02 1.006999999999999895e+00 8.435000000000000275e-01 2.246500000000000163e+00 8.209999999999999520e-01
1.800000000000000000e+01 4.300000000000000000e+01 -1.000000000000000000e+00 -1.000000000000000000e+00 -1.000000000000000000e+00 -1.000000000000000000e+00 -1.000000000000000000e+00 1.197335000000000036e+03 4.695880000000000223e+02 1.173000000000000043e+00 8.415000000000000258e-01 2.059499999999999886e+00 7.740000000000000213e-01
1.900000000000000000e+01 4.000000000000000000e+01 -1.000000000000000000e+00 -1.000000000000000000e+00 -1.000000000000000000e+00 -1.000000000000000000e+00 -1.000000000000000000e+00 1.195817000000000007e+03 4.669889999999999759e+02 9.759999999999999787e-01 8.485000000000000320e-01 2.061999999999999833e+00 8.235000000000000098e-01
1.900000000000000000e+01 4.200000000000000000e+01 -1.000000000000000000e+00 -1.000000000000000000e+00 -1.000000000000000000e+00 -1.000000000000000000e+00 -1.000000000000000000e+00 1.196770999999999958e+03 4.725439999999999827e+02 8.820000000000000062e-01 8.435000000000000275e-01 2.246500000000000163e+00 8.209999999999999520e-01
1.900000000000000000e+01 4.300000000000000000e+01 -1.000000000000000000e+00 -1.000000000000000000e+00 -1.000000000000000000e+00 -1.000000000000000000e+00 -1.000000000000000000e+00 1.197325000000000045e+03 4.694610000000000127e+02 9.719999999999999751e-01 8.415000000000000258e-01 2.059499999999999886e+00 7.740000000000000213e-01
2.000000000000000000e+01 4.000000000000000000e+01 -1.000000000000000000e+00 -1.000000000000000000e+00 -1.000000000000000000e+00 -1.000000000000000000e+00 -1.000000000000000000e+00 1.195765000000000100e+03 4.670140000000000100e+02 8.409999999999999698e-01 8.485000000000000320e-01 2.061999999999999833e+00 8.235000000000000098e-01
2.000000000000000000e+01 4.200000000000000000e+01 -1.000000000000000000e+00 -1.000000000000000000e+00 -1.000000000000000000e+00 -1.000000000000000000e+00 -1.000000000000000000e+00 1.196713999999999942e+03 4.725020000000000095e+02 7.570000000000000062e-01 8.435000000000000275e-01 2.246500000000000163e+00 8.209999999999999520e-01
2.000000000000000000e+01 4.300000000000000000e+01 -1.000000000000000000e+00 -1.000000000000000000e+00 -1.000000000000000000e+00 -1.000000000000000000e+00 -1.000000000000000000e+00 1.197251999999999953e+03 4.693419999999999845e+02 8.139999999999999458e-01 8.415000000000000258e-01 2.059499999999999886e+00 7.740000000000000213e-01
2.100000000000000000e+01 4.000000000000000000e+01 -1.000000000000000000e+00 -1.000000000000000000e+00 -1.000000000000000000e+00 -1.000000000000000000e+00 -1.000000000000000000e+00 1.195740000000000009e+03 4.669739999999999895e+02 5.809999999999999609e-01 8.485000000000000320e-01 2.061999999999999833e+00 8.235000000000000098e-01
2.100000000000000000e+01 4.200000000000000000e+01 -1.000000000000000000e+00 -1.000000000000000000e+00 -1.000000000000000000e+00 -1.000000000000000000e+00 -1.000000000000000000e+00 1.196583000000000084e+03 4.725830000000000268e+02 5.070000000000000062e-01 8.435000000000000275e-01 2.246500000000000163e+00 8.209999999999999520e-01
2.100000000000000000e+01 4.300000000000000000e+01 -1.000000000000000000e+00 -1.000000000000000000e+00 -1.000000000000000000e+00 -1.000000000000000000e+00 -1.000000000000000000e+00 1.197231999999999971e+03 4.691059999999999945e+02 5.919999999999999707e-01 8.415000000000000258e-01 2.059499999999999886e+00 7.740000000000000213e-01
2.200000000000000000e+01 4.000000000000000000e+01 -1.000000000000000000e+00 -1.000000000000000000e+00 -1.000000000000000000e+00 -1.000000000000000000e+00 -1.000000000000000000e+00 1.195756000000000085e+03 4.670009999999999764e+02 3.459999999999999742e-01 8.485000000000000320e-01 2.061999999999999833e+00 8.235000000000000098e-01
2.200000000000000000e+01 4.200000000000000000e+01 -1.000000000000000000e+00 -1.000000000000000000e+00 -1.000000000000000000e+00 -1.000000000000000000e+00 -1.000000000000000000e+00 1.196457000000000107e+03 4.725960000000000036e+02 2.570000000000000062e-01 8.435000000000000275e-01 2.246500000000000163e+00 8.209999999999999520e-01
2.200000000000000000e+01 4.300000000000000000e+01 -1.000000000000000000e+00 -1.000000000000000000e+00 -1.000000000000000000e+00 -1.000000000000000000e+00 -1.000000000000000000e+00 1.197280999999999949e+03 4.692789999999999964e+02 3.109999999999999987e-01 8.415000000000000258e-01 2.059499999999999886e+00 7.740000000000000213e-01
2.300000000000000000e+01 4.000000000000000000e+01 -1.000000000000000000e+00 -1.000000000000000000e+00 -1.000000000000000000e+00 -1.000000000000000000e+00 -1.000000000000000000e+00 1.195772999999999911e+03 4.670280000000000200e+02 1.110000000000000014e-01 8.485000000000000320e-01 2.061999999999999833e+00 8.235000000000000098e-01
2.300000000000000000e+01 4.200000000000000000e+01 -1.000000000000000000e+00 -1.000000000000000000e+00 -1.000000000000000000e+00 -1.000000000000000000e+00 -1.000000000000000000e+00 1.196566000000000031e+03 4.726190000000000282e+02 7.000000000000000146e-03 8.435000000000000275e-01 2.246500000000000163e+00 8.209999999999999520e-01
2.300000000000000000e+01 4.300000000000000000e+01 -1.000000000000000000e+00 -1.000000000000000000e+00 -1.000000000000000000e+00 -1.000000000000000000e+00 -1.000000000000000000e+00 1.197436999999999898e+03 4.694259999999999877e+02 1.310000000000000053e-01 8.415000000000000258e-01 2.059499999999999886e+00 7.740000000000000213e-01
2.400000000000000000e+01 4.000000000000000000e+01 -1.000000000000000000e+00 -1.000000000000000000e+00 -1.000000000000000000e+00 -1.000000000000000000e+00 -1.000000000000000000e+00 1.195804000000000087e+03 4.670509999999999877e+02 -9.900000000000000466e-02 8.485000000000000320e-01 2.061999999999999833e+00 8.235000000000000098e-01
2.400000000000000000e+01 4.200000000000000000e+01 -1.000000000000000000e+00 -1.000000000000000000e+00 -1.000000000000000000e+00 -1.000000000000000000e+00 -1.000000000000000000e+00 1.196457000000000107e+03 4.725960000000000036e+02 -2.429999999999999938e-01 8.435000000000000275e-01 2.246500000000000163e+00 8.209999999999999520e-01
2.400000000000000000e+01 4.300000000000000000e+01 -1.000000000000000000e+00 -1.000000000000000000e+00 -1.000000000000000000e+00 -1.000000000000000000e+00 -1.000000000000000000e+00 1.197292999999999893e+03 4.692730000000000246e+02 -1.250000000000000000e-01 8.415000000000000258e-01 2.059499999999999886e+00 7.740000000000000213e-01
2.500000000000000000e+01 4.200000000000000000e+01 -1.000000000000000000e+00 -1.000000000000000000e+00 -1.000000000000000000e+00 -1.000000000000000000e+00 -1.000000000000000000e+00 1.196700000000000045e+03 4.725430000000000064e+02 -4.929999999999999938e-01 8.435000000000000275e-01 2.246500000000000163e+00 8.209999999999999520e-01
2.500000000000000000e+01 4.300000000000000000e+01 -1.000000000000000000e+00 -1.000000000000000000e+00 -1.000000000000000000e+00 -1.000000000000000000e+00 -1.000000000000000000e+00 1.197336999999999989e+03 4.692799999999999727e+02 -3.469999999999999751e-01 8.415000000000000258e-01 2.059499999999999886e+00 7.740000000000000213e-01
2.600000000000000000e+01 4.200000000000000000e+01 -1.000000000000000000e+00 -1.000000000000000000e+00 -1.000000000000000000e+00 -1.000000000000000000e+00 -1.000000000000000000e+00 1.196801999999999907e+03 4.726639999999999873e+02 -7.930000000000000382e-01 8.435000000000000275e-01 2.246500000000000163e+00 8.209999999999999520e-01
2.600000000000000000e+01 4.300000000000000000e+01 -1.000000000000000000e+00 -1.000000000000000000e+00 -1.000000000000000000e+00 -1.000000000000000000e+00 -1.000000000000000000e+00 1.197161000000000058e+03 4.694420000000000073e+02 -5.689999999999999503e-01 8.415000000000000258e-01 2.059499999999999886e+00 7.740000000000000213e-01
2.700000000000000000e+01 4.200000000000000000e+01 -1.000000000000000000e+00 -1.000000000000000000e+00 -1.000000000000000000e+00 -1.000000000000000000e+00 -1.000000000000000000e+00 1.196741999999999962e+03 4.726809999999999832e+02 -9.929999999999999938e-01 8.435000000000000275e-01 2.246500000000000163e+00 8.209999999999999520e-01
2.700000000000000000e+01 4.300000000000000000e+01 -1.000000000000000000e+00 -1.000000000000000000e+00 -1.000000000000000000e+00 -1.000000000000000000e+00 -1.000000000000000000e+00 1.196958000000000084e+03 4.696109999999999900e+02 -8.419999999999999707e-01 8.415000000000000258e-01 2.059499999999999886e+00 7.740000000000000213e-01
