1.500000000000000000e+01 5.550000000000000000e+03 -1.000000000000000000e+00 -1.000000000000000000e+00 -1.000000000000000000e+00 -1.000000000000000000e+00 -1.000000000000000000e+00 1.166499000000000024e+03 1.362663999999999987e+03 3.484999999999999876e+00 3.145000000000000018e-01 4.000000000000000222e-01 8.625000000000000444e-01
1.600000000000000000e+01 5.550000000000000000e+03 -1.000000000000000000e+00 -1.000000000000000000e+00 -1.000000000000000000e+00 -1.000000000000000000e+00 -1.000000000000000000e+00 1.166807999999999993e+03 1.362423000000000002e+03 3.285000000000000142e+00 3.145000000000000018e-01 4.000000000000000222e-01 8.625000000000000444e-01
1.700000000000000000e+01 5.551000000000000000e+03 -1.000000000000000000e+00 -1.000000000000000000e+00 -1.000000000000000000e+00 -1.000000000000000000e+00 -1.000000000000000000e+00 1.186682000000000016e+03 1.353865000000000009e+03 3.826000000000000068e+00 3.629999999999999893e-01 3.335000000000000187e-01 9.174999999999999822e-01
1.700000000000000000e+01 5.550000000000000000e+03 -1.000000000000000000e+00 -1.000000000000000000e+00 -1.000000000000000000e+00 -1.000000000000000000e+00 -1.000000000000000000e+00 1.167075000000000045e+03 1.362127999999999929e+03 3.234999999999999876e+00 3.145000000000000018e-01 4.000000000000000222e-01 8.625000000000000444e-01
1.800000000000000000e+01 5.551000000000000000e+03 -1.000000000000000000e+00 -1.000000000000000000e+00 -1.000000000000000000e+00 -1.000000000000000000e+00 -1.000000000000000000e+00 1.186086000000000013e+03 1.353588999999999942e+03 3.689999999999999947e+00 3.629999999999999893e-01 3.335000000000000187e-01 9.174999999999999822e-01
1.800000000000000000e+01 5.550000000000000000e+03 -1.000000000000000000e+00 -1.000000000000000000e+00 -1.000000000000000000e+00 -1.000000000000000000e+00 -1.000000000000000000e+00 1.167368999999999915e+03 1.361801999999999907e+03 3.129999999999999893e+00 3.145000000000000018e-01 4.000000000000000222e-01 8.625000000000000444e-01
1.900000000000000000e+01 5.551000000000000000e+03 -1.000000000000000000e+00 -1.000000000000000000e+00 -1.000000000000000000e+00 -1.000000000000000000e+00 -1.000000000000000000e+00 1.185544000000000096e+03 1.353336999999999989e+03 3.565999999999999837e+00 3.629999999999999893e-01 3.335000000000000187e-01 9.174999999999999822e-01
2.000000000000000000e+01 5.551000000000000000e+03 -1.000000000000000000e+00 -1.000000000000000000e+00 -1.000000000000000000e+00 -1.000000000000000000e+00 -1.000000000000000000e+00 1.184963999999999942e+03 1.353095000000000027e+03 3.315999999999999837e+00 3.629999999999999893e-01 3.335000000000000187e-01 9.174999999999999822e-01
2.100000000000000000e+01 5.551000000000000000e+03 -1.000000000000000000e+00 -1.000000000000000000e+00 -1.000000000000000000e+00 -1.000000000000000000e+00 -1.000000000000000000e+00 1.184230000000000018e+03 1.352885999999999967e+03 3.216000000000000192e+00 3.629999999999999893e-01 3.335000000000000187e-01 9.174999999999999822e-01
2.200000000000000000e+01 5.551000000000000000e+03 -1.000000000000000000e+00 -1.000000000000000000e+00 -1.000000000000000000e+00 -1.000000000000000000e+00 -1.000000000000000000e+00 1.183673000000000002e+03 1.352702999999999975e+03 3.216000000000000192e+00 3.629999999999999893e-01 3.335000000000000187e-01 9.174999999999999822e-01
2.300000000000000000e+01 5.551000000000000000e+03 -1.000000000000000000e+00 -1.000000000000000000e+00 -1.000000000000000000e+00 -1.000000000000000000e+00 -1.000000000000000000e+00 1.183117999999999938e+03 1.352519999999999982e+03 2.920999999999999819e+00 3.629999999999999893e-01 3.335000000000000187e-01 9.174999999999999822e-01
