8.000000000000000000e+00 4.100000000000000000e+01 -1.000000000000000000e+00 -1.000000000000000000e+00 -1.000000000000000000e+00 -1.000000000000000000e+00 -1.000000000000000000e+00 1.182144000000000005e+03 4.635480000000000018e+02 2.528000000000000025e+00 2.404999999999999916e-01 2.500000000000000000e-01 7.479999999999999982e-01
9.000000000000000000e+00 4.100000000000000000e+01 -1.000000000000000000e+00 -1.000000000000000000e+00 -1.000000000000000000e+00 -1.000000000000000000e+00 -1.000000000000000000e+00 1.182161000000000058e+03 4.635419999999999732e+02 2.327999999999999847e+00 2.404999999999999916e-01 2.500000000000000000e-01 7.479999999999999982e-01
1.000000000000000000e+01 4.100000000000000000e+01 -1.000000000000000000e+00 -1.000000000000000000e+00 -1.000000000000000000e+00 -1.000000000000000000e+00 -1.000000000000000000e+00 1.182150000000000091e+03 4.635459999999999923e+02 2.077999999999999847e+00 2.404999999999999916e-01 2.500000000000000000e-01 7.479999999999999982e-01
1.100000000000000000e+01 4.100000000000000000e+01 -1.000000000000000000e+00 -1.000000000000000000e+00 -1.000000000000000000e+00 -1.000000000000000000e+00 -1.000000000000000000e+00 1.182037000000000035e+03 4.634750000000000227e+02 1.804000000000000048e+00 2.404999999999999916e-01 2.500000000000000000e-01 7.479999999999999982e-01
1.200000000000000000e+01 4.100000000000000000e+01 -1.000000000000000000e+00 -1.000000000000000000e+00 -1.000000000000000000e+00 -1.000000000000000000e+00 -1.000000000000000000e+00 1.181981999999999971e+03 4.634879999999999995e+02 1.522999999999999909e+00 2.404999999999999916e-01 2.500000000000000000e-01 7.479999999999999982e-01
1.300000000000000000e+01 4.100000000000000000e+01 -1.000000000000000000e+00 -1.000000000000000000e+00 -1.000000000000000000e+00 -1.000000000000000000e+00 -1.000000000000000000e+00 1.181971000000000004e+03 4.634920000000000186e+02 1.322999999999999954e+00 2.404999999999999916e-01 2.500000000000000000e-01 7.479999999999999982e-01
1.400000000000000000e+01 4.100000000000000000e+01 -1.000000000000000000e+00 -1.000000000000000000e+00 -1.000000000000000000e+00 -1.000000000000000000e+00 -1.000000000000000000e+00 1.181885999999999967e+03 4.634499999999999886e+02 1.223000000000000087e+00 2.404999999999999916e-01 2.500000000000000000e-01 7.479999999999999982e-01
1.500000000000000000e+01 4.100000000000000000e+01 -1.000000000000000000e+00 -1.000000000000000000e+00 -1.000000000000000000e+00 -1.000000000000000000e+00 -1.000000000000000000e+00 1.181858999999999924e+03 4.633700000000000045e+02 1.082999999999999963e+00 2.404999999999999916e-01 2.500000000000000000e-01 7.479999999999999982e-01
1.600000000000000000e+01 4.100000000000000000e+01 -1.000000000000000000e+00 -1.000000000000000000e+00 -1.000000000000000000e+00 -1.000000000000000000e+00 -1.000000000000000000e+00 1.181835000000000036e+03 4.633009999999999877e+02 9.330000000000000515e-01 2.404999999999999916e-01 2.500000000000000000e-01 7.479999999999999982e-01
1.700000000000000000e+01 4.100000000000000000e+01 -1.000000000000000000e+00 -1.000000000000000000e+00 -1.000000000000000000e+00 -1.000000000000000000e+00 -1.000000000000000000e+00 1.181773999999999887e+03 4.632450000000000045e+02 8.579999999999999849e-01 2.404999999999999916e-01 2.500000000000000000e-01 7.479999999999999982e-01
1.800000000000000000e+01 4.100000000000000000e+01 -1.000000000000000000e+00 -1.000000000000000000e+00 -1.000000000000000000e+00 -1.000000000000000000e+00 -1.000000000000000000e+00 1.181760999999999967e+03 4.633260000000000218e+02 6.830000000000000515e-01 2.404999999999999916e-01 2.500000000000000000e-01 7.479999999999999982e-01
