1.000000000000000000e+00 3.538000000000000000e+03 -1.000000000000000000e+00 -1.000000000000000000e+00 -1.000000000000000000e+00 -1.000000000000000000e+00 -1.000000000000000000e+00 1.239113000000000056e+03 1.374556000000000040e+03 6.480000000000000204e-01 3.009999999999999898e-01 7.255000000000000338e-01 5.000000000000000000e-01
2.000000000000000000e+00 3.538000000000000000e+03 -1.000000000000000000e+00 -1.000000000000000000e+00 -1.000000000000000000e+00 -1.000000000000000000e+00 -1.000000000000000000e+00 1.239113000000000056e+03 1.374556000000000040e+03 6.480000000000000204e-01 3.009999999999999898e-01 7.255000000000000338e-01 5.000000000000000000e-01
3.000000000000000000e+00 3.538000000000000000e+03 -1.000000000000000000e+00 -1.000000000000000000e+00 -1.000000000000000000e+00 -1.000000000000000000e+00 -1.000000000000000000e+00 1.239113000000000056e+03 1.374556000000000040e+03 6.480000000000000204e-01 3.009999999999999898e-01 7.255000000000000338e-01 5.000000000000000000e-01
4.000000000000000000e+00 3.538000000000000000e+03 -1.000000000000000000e+00 -1.000000000000000000e+00 -1.000000000000000000e+00 -1.000000000000000000e+00 -1.000000000000000000e+00 1.239113000000000056e+03 1.374556000000000040e+03 6.480000000000000204e-01 3.009999999999999898e-01 7.255000000000000338e-01 5.000000000000000000e-01
5.000000000000000000e+00 3.538000000000000000e+03 -1.000000000000000000e+00 -1.000000000000000000e+00 -1.000000000000000000e+00 -1.000000000000000000e+00 -1.000000000000000000e+00 1.239113000000000056e+03 1.374556000000000040e+03 6.480000000000000204e-01 3.009999999999999898e-01 7.255000000000000338e-01 5.000000000000000000e-01
6.000000000000000000e+00 3.538000000000000000e+03 -1.000000000000000000e+00 -1.000000000000000000e+00 -1.000000000000000000e+00 -1.000000000000000000e+00 -1.000000000000000000e+00 1.239113000000000056e+03 1.374556000000000040e+03 6.480000000000000204e-01 3.009999999999999898e-01 7.255000000000000338e-01 5.000000000000000000e-01
7.000000000000000000e+00 3.538000000000000000e+03 -1.000000000000000000e+00 -1.000000000000000000e+00 -1.000000000000000000e+00 -1.000000000000000000e+00 -1.000000000000000000e+00 1.239113000000000056e+03 1.374556000000000040e+03 6.480000000000000204e-01 3.009999999999999898e-01 7.255000000000000338e-01 5.000000000000000000e-01
8.000000000000000000e+00 3.538000000000000000e+03 -1.000000000000000000e+00 -1.000000000000000000e+00 -1.000000000000000000e+00 -1.000000000000000000e+00 -1.000000000000000000e+00 1.239113000000000056e+03 1.374556000000000040e+03 6.480000000000000204e-01 3.009999999999999898e-01 7.255000000000000338e-01 5.000000000000000000e-01
8.000000000000000000e+00 3.568000000000000000e+03 -1.000000000000000000e+00 -1.000000000000000000e+00 -1.000000000000000000e+00 -1.000000000000000000e+00 -1.000000000000000000e+00 1.217967000000000098e+03 1.391936999999999898e+03 1.137999999999999901e+00 3.915000000000000147e-01 6.284999999999999476e-01 8.944999999999999618e-01
9.000000000000000000e+00 3.538000000000000000e+03 -1.000000000000000000e+00 -1.000000000000000000e+00 -1.000000000000000000e+00 -1.000000000000000000e+00 -1.000000000000000000e+00 1.239113000000000056e+03 1.374556000000000040e+03 6.480000000000000204e-01 3.009999999999999898e-01 7.255000000000000338e-01 5.000000000000000000e-01
9.000000000000000000e+00 3.568000000000000000e+03 -1.000000000000000000e+00 -1.000000000000000000e+00 -1.000000000000000000e+00 -1.000000000000000000e+00 -1.000000000000000000e+00 1.215490999999999985e+03 1.393526000000000067e+03 1.139000000000000012e+00 3.915000000000000147e-01 6.284999999999999476e-01 8.944999999999999618e-01
1.000000000000000000e+01 3.538000000000000000e+03 -1.000000000000000000e+00 -1.000000000000000000e+00 -1.000000000000000000e+00 -1.000000000000000000e+00 -1.000000000000000000e+00 1.239113000000000056e+03 1.374556000000000040e+03 6.480000000000000204e-01 3.009999999999999898e-01 7.255000000000000338e-01 5.000000000000000000e-01
1.000000000000000000e+01 3.568000000000000000e+03 -1.000000000000000000e+00 -1.000000000000000000e+00 -1.000000000000000000e+00 -1.000000000000000000e+00 -1.000000000000000000e+00 1.213439000000000078e+03 1.394856999999999971e+03 1.288000000000000034e+00 3.915000000000000147e-01 6.284999999999999476e-01 8.944999999999999618e-01
1.100000000000000000e+01 3.538000000000000000e+03 -1.000000000000000000e+00 -1.000000000000000000e+00 -1.000000000000000000e+00 -1.000000000000000000e+00 -1.000000000000000000e+00 1.239113000000000056e+03 1.374556000000000040e+03 6.480000000000000204e-01 3.009999999999999898e-01 7.255000000000000338e-01 5.000000000000000000e-01
1.100000000000000000e+01 3.568000000000000000e+03 -1.000000000000000000e+00 -1.000000000000000000e+00 -1.000000000000000000e+00 -1.000000000000000000e+00 -1.000000000000000000e+00 1.211384999999999991e+03 1.396190000000000055e+03 1.439000000000000057e+00 3.915000000000000147e-01 6.284999999999999476e-01 8.944999999999999618e-01
1.200000000000000000e+01 3.538000000000000000e+03 -1.000000000000000000e+00 -1.000000000000000000e+00 -1.000000000000000000e+00 -1.000000000000000000e+00 -1.000000000000000000e+00 1.239113000000000056e+03 1.374556000000000040e+03 6.209999999999999964e-01 3.009999999999999898e-01 7.255000000000000338e-01 5.000000000000000000e-01
1.200000000000000000e+01 3.568000000000000000e+03 -1.000000000000000000e+00 -1.000000000000000000e+00 -1.000000000000000000e+00 -1.000000000000000000e+00 -1.000000000000000000e+00 1.209401000000000067e+03 1.397487000000000080e+03 1.439000000000000057e+00 3.915000000000000147e-01 6.284999999999999476e-01 8.944999999999999618e-01
1.300000000000000000e+01 3.538000000000000000e+03 -1.000000000000000000e+00 -1.000000000000000000e+00 -1.000000000000000000e+00 -1.000000000000000000e+00 -1.000000000000000000e+00 1.239113000000000056e+03 1.374556000000000040e+03 5.939999999999999725e-01 3.009999999999999898e-01 7.255000000000000338e-01 5.000000000000000000e-01
1.300000000000000000e+01 3.568000000000000000e+03 -1.000000000000000000e+00 -1.000000000000000000e+00 -1.000000000000000000e+00 -1.000000000000000000e+00 -1.000000000000000000e+00 1.207419000000000096e+03 1.398781999999999925e+03 1.489000000000000101e+00 3.915000000000000147e-01 6.284999999999999476e-01 8.944999999999999618e-01
1.400000000000000000e+01 3.538000000000000000e+03 -1.000000000000000000e+00 -1.000000000000000000e+00 -1.000000000000000000e+00 -1.000000000000000000e+00 -1.000000000000000000e+00 1.239113000000000056e+03 1.374556000000000040e+03 5.939999999999999725e-01 3.009999999999999898e-01 7.255000000000000338e-01 5.000000000000000000e-01
1.400000000000000000e+01 3.568000000000000000e+03 -1.000000000000000000e+00 -1.000000000000000000e+00 -1.000000000000000000e+00 -1.000000000000000000e+00 -1.000000000000000000e+00 1.205433999999999969e+03 1.400077999999999975e+03 1.489000000000000101e+00 3.915000000000000147e-01 6.284999999999999476e-01 8.944999999999999618e-01
1.500000000000000000e+01 3.538000000000000000e+03 -1.000000000000000000e+00 -1.000000000000000000e+00 -1.000000000000000000e+00 -1.000000000000000000e+00 -1.000000000000000000e+00 1.239113000000000056e+03 1.374556000000000040e+03 5.939999999999999725e-01 3.009999999999999898e-01 7.255000000000000338e-01 5.000000000000000000e-01
1.500000000000000000e+01 3.568000000000000000e+03 -1.000000000000000000e+00 -1.000000000000000000e+00 -1.000000000000000000e+00 -1.000000000000000000e+00 -1.000000000000000000e+00 1.203557000000000016e+03 1.401078999999999951e+03 1.463999999999999968e+00 3.915000000000000147e-01 6.284999999999999476e-01 8.944999999999999618e-01
1.600000000000000000e+01 3.538000000000000000e+03 -1.000000000000000000e+00 -1.000000000000000000e+00 -1.000000000000000000e+00 -1.000000000000000000e+00 -1.000000000000000000e+00 1.239113000000000056e+03 1.374556000000000040e+03 5.939999999999999725e-01 3.009999999999999898e-01 7.255000000000000338e-01 5.000000000000000000e-01
1.600000000000000000e+01 3.568000000000000000e+03 -1.000000000000000000e+00 -1.000000000000000000e+00 -1.000000000000000000e+00 -1.000000000000000000e+00 -1.000000000000000000e+00 1.201681000000000040e+03 1.402077999999999975e+03 1.439000000000000057e+00 3.915000000000000147e-01 6.284999999999999476e-01 8.944999999999999618e-01
1.700000000000000000e+01 3.538000000000000000e+03 -1.000000000000000000e+00 -1.000000000000000000e+00 -1.000000000000000000e+00 -1.000000000000000000e+00 -1.000000000000000000e+00 1.239113000000000056e+03 1.374556000000000040e+03 5.939999999999999725e-01 3.009999999999999898e-01 7.255000000000000338e-01 5.000000000000000000e-01
1.700000000000000000e+01 3.568000000000000000e+03 -1.000000000000000000e+00 -1.000000000000000000e+00 -1.000000000000000000e+00 -1.000000000000000000e+00 -1.000000000000000000e+00 1.199805000000000064e+03 1.403077999999999975e+03 1.413999999999999924e+00 3.915000000000000147e-01 6.284999999999999476e-01 8.944999999999999618e-01
1.800000000000000000e+01 3.568000000000000000e+03 -1.000000000000000000e+00 -1.000000000000000000e+00 -1.000000000000000000e+00 -1.000000000000000000e+00 -1.000000000000000000e+00 1.198117999999999938e+03 1.403977000000000089e+03 1.391000000000000014e+00 3.915000000000000147e-01 6.284999999999999476e-01 8.944999999999999618e-01
1.900000000000000000e+01 3.568000000000000000e+03 -1.000000000000000000e+00 -1.000000000000000000e+00 -1.000000000000000000e+00 -1.000000000000000000e+00 -1.000000000000000000e+00 1.196663999999999987e+03 1.405147999999999911e+03 1.366000000000000103e+00 3.915000000000000147e-01 6.284999999999999476e-01 8.944999999999999618e-01
2.000000000000000000e+01 3.568000000000000000e+03 -1.000000000000000000e+00 -1.000000000000000000e+00 -1.000000000000000000e+00 -1.000000000000000000e+00 -1.000000000000000000e+00 1.195257000000000062e+03 1.406647999999999911e+03 1.338999999999999968e+00 3.915000000000000147e-01 6.284999999999999476e-01 8.944999999999999618e-01
