4.000000000000000000e+00 3.514000000000000000e+03 -1.000000000000000000e+00 -1.000000000000000000e+00 -1.000000000000000000e+00 -1.000000000000000000e+00 -1.000000000000000000e+00 1.334503999999999905e+03 1.322269999999999982e+03 6.889999999999999458e-01 2.919999999999999818e-01 8.219999999999999529e-01 5.765000000000000124e-01
5.000000000000000000e+00 3.514000000000000000e+03 -1.000000000000000000e+00 -1.000000000000000000e+00 -1.000000000000000000e+00 -1.000000000000000000e+00 -1.000000000000000000e+00 1.334503999999999905e+03 1.322269999999999982e+03 6.889999999999999458e-01 2.919999999999999818e-01 8.219999999999999529e-01 5.765000000000000124e-01
6.000000000000000000e+00 3.514000000000000000e+03 -1.000000000000000000e+00 -1.000000000000000000e+00 -1.000000000000000000e+00 -1.000000000000000000e+00 -1.000000000000000000e+00 1.334503999999999905e+03 1.322269999999999982e+03 6.889999999999999458e-01 2.919999999999999818e-01 8.219999999999999529e-01 5.765000000000000124e-01
7.000000000000000000e+00 3.514000000000000000e+03 -1.000000000000000000e+00 -1.000000000000000000e+00 -1.000000000000000000e+00 -1.000000000000000000e+00 -1.000000000000000000e+00 1.334503999999999905e+03 1.322269999999999982e+03 6.889999999999999458e-01 2.919999999999999818e-01 8.219999999999999529e-01 5.765000000000000124e-01
8.000000000000000000e+00 3.514000000000000000e+03 -1.000000000000000000e+00 -1.000000000000000000e+00 -1.000000000000000000e+00 -1.000000000000000000e+00 -1.000000000000000000e+00 1.334503999999999905e+03 1.322269999999999982e+03 6.889999999999999458e-01 2.919999999999999818e-01 8.219999999999999529e-01 5.765000000000000124e-01
9.000000000000000000e+00 3.514000000000000000e+03 -1.000000000000000000e+00 -1.000000000000000000e+00 -1.000000000000000000e+00 -1.000000000000000000e+00 -1.000000000000000000e+00 1.334503999999999905e+03 1.322269999999999982e+03 6.889999999999999458e-01 2.919999999999999818e-01 8.219999999999999529e-01 5.765000000000000124e-01
1.000000000000000000e+01 3.514000000000000000e+03 -1.000000000000000000e+00 -1.000000000000000000e+00 -1.000000000000000000e+00 -1.000000000000000000e+00 -1.000000000000000000e+00 1.334492999999999938e+03 1.322271999999999935e+03 6.889999999999999458e-01 2.919999999999999818e-01 8.219999999999999529e-01 5.765000000000000124e-01
1.100000000000000000e+01 3.514000000000000000e+03 -1.000000000000000000e+00 -1.000000000000000000e+00 -1.000000000000000000e+00 -1.000000000000000000e+00 -1.000000000000000000e+00 1.334481999999999971e+03 1.322273999999999887e+03 6.889999999999999458e-01 2.919999999999999818e-01 8.219999999999999529e-01 5.765000000000000124e-01
1.200000000000000000e+01 3.514000000000000000e+03 -1.000000000000000000e+00 -1.000000000000000000e+00 -1.000000000000000000e+00 -1.000000000000000000e+00 -1.000000000000000000e+00 1.334471000000000004e+03 1.322276000000000067e+03 6.889999999999999458e-01 2.919999999999999818e-01 8.219999999999999529e-01 5.765000000000000124e-01
1.300000000000000000e+01 3.514000000000000000e+03 -1.000000000000000000e+00 -1.000000000000000000e+00 -1.000000000000000000e+00 -1.000000000000000000e+00 -1.000000000000000000e+00 1.334471000000000004e+03 1.322276000000000067e+03 6.889999999999999458e-01 2.919999999999999818e-01 8.219999999999999529e-01 5.765000000000000124e-01
1.400000000000000000e+01 3.514000000000000000e+03 -1.000000000000000000e+00 -1.000000000000000000e+00 -1.000000000000000000e+00 -1.000000000000000000e+00 -1.000000000000000000e+00 1.334471000000000004e+03 1.322276000000000067e+03 6.889999999999999458e-01 2.919999999999999818e-01 8.219999999999999529e-01 5.765000000000000124e-01
1.500000000000000000e+01 3.514000000000000000e+03 -1.000000000000000000e+00 -1.000000000000000000e+00 -1.000000000000000000e+00 -1.000000000000000000e+00 -1.000000000000000000e+00 1.334471000000000004e+03 1.322276000000000067e+03 6.889999999999999458e-01 2.919999999999999818e-01 8.219999999999999529e-01 5.765000000000000124e-01
1.600000000000000000e+01 3.514000000000000000e+03 -1.000000000000000000e+00 -1.000000000000000000e+00 -1.000000000000000000e+00 -1.000000000000000000e+00 -1.000000000000000000e+00 1.334471000000000004e+03 1.322276000000000067e+03 6.889999999999999458e-01 2.919999999999999818e-01 8.219999999999999529e-01 5.765000000000000124e-01
1.700000000000000000e+01 3.514000000000000000e+03 -1.000000000000000000e+00 -1.000000000000000000e+00 -1.000000000000000000e+00 -1.000000000000000000e+00 -1.000000000000000000e+00 1.334471000000000004e+03 1.322276000000000067e+03 6.889999999999999458e-01 2.919999999999999818e-01 8.219999999999999529e-01 5.765000000000000124e-01
1.800000000000000000e+01 3.514000000000000000e+03 -1.000000000000000000e+00 -1.000000000000000000e+00 -1.000000000000000000e+00 -1.000000000000000000e+00 -1.000000000000000000e+00 1.334471000000000004e+03 1.322276000000000067e+03 6.889999999999999458e-01 2.919999999999999818e-01 8.219999999999999529e-01 5.765000000000000124e-01
