1.000000000000000000e+00 1.430000000000000000e+03 -1.000000000000000000e+00 -1.000000000000000000e+00 -1.000000000000000000e+00 -1.000000000000000000e+00 -1.000000000000000000e+00 1.023403999999999996e+03 1.396101000000000113e+03 7.179999999999999716e-01 4.944999999999999951e-01 1.189999999999999947e+00 6.304999999999999494e-01
2.000000000000000000e+00 1.447000000000000000e+03 -1.000000000000000000e+00 -1.000000000000000000e+00 -1.000000000000000000e+00 -1.000000000000000000e+00 -1.000000000000000000e+00 1.017451000000000022e+03 1.393579999999999927e+03 6.610000000000000320e-01 4.304999999999999938e-01 1.139499999999999957e+00 6.864999999999999991e-01
2.000000000000000000e+00 1.430000000000000000e+03 -1.000000000000000000e+00 -1.000000000000000000e+00 -1.000000000000000000e+00 -1.000000000000000000e+00 -1.000000000000000000e+00 1.023403999999999996e+03 1.396101000000000113e+03 6.680000000000000382e-01 4.944999999999999951e-01 1.189999999999999947e+00 6.304999999999999494e-01
3.000000000000000000e+00 1.447000000000000000e+03 -1.000000000000000000e+00 -1.000000000000000000e+00 -1.000000000000000000e+00 -1.000000000000000000e+00 -1.000000000000000000e+00 1.017408999999999992e+03 1.393602000000000089e+03 6.610000000000000320e-01 4.304999999999999938e-01 1.139499999999999957e+00 6.864999999999999991e-01
3.000000000000000000e+00 1.430000000000000000e+03 -1.000000000000000000e+00 -1.000000000000000000e+00 -1.000000000000000000e+00 -1.000000000000000000e+00 -1.000000000000000000e+00 1.023374000000000024e+03 1.396176999999999907e+03 6.860000000000000542e-01 4.944999999999999951e-01 1.189999999999999947e+00 6.304999999999999494e-01
4.000000000000000000e+00 1.430000000000000000e+03 -1.000000000000000000e+00 -1.000000000000000000e+00 -1.000000000000000000e+00 -1.000000000000000000e+00 -1.000000000000000000e+00 1.023405999999999949e+03 1.396020999999999958e+03 6.860000000000000542e-01 4.944999999999999951e-01 1.189999999999999947e+00 6.304999999999999494e-01
4.000000000000000000e+00 1.447000000000000000e+03 -1.000000000000000000e+00 -1.000000000000000000e+00 -1.000000000000000000e+00 -1.000000000000000000e+00 -1.000000000000000000e+00 1.017412550330436943e+03 1.393600224834781557e+03 6.610000000000000320e-01 4.304999999999999938e-01 1.139499999999999957e+00 6.864999999999999991e-01
5.000000000000000000e+00 1.447000000000000000e+03 -1.000000000000000000e+00 -1.000000000000000000e+00 -1.000000000000000000e+00 -1.000000000000000000e+00 -1.000000000000000000e+00 1.017417000000000030e+03 1.393597999999999956e+03 6.610000000000000320e-01 4.304999999999999938e-01 1.139499999999999957e+00 6.864999999999999991e-01
5.000000000000000000e+00 1.430000000000000000e+03 -1.000000000000000000e+00 -1.000000000000000000e+00 -1.000000000000000000e+00 -1.000000000000000000e+00 -1.000000000000000000e+00 1.023389000000000010e+03 1.396142000000000053e+03 6.360000000000000098e-01 4.944999999999999951e-01 1.189999999999999947e+00 6.304999999999999494e-01
6.000000000000000000e+00 1.447000000000000000e+03 -1.000000000000000000e+00 -1.000000000000000000e+00 -1.000000000000000000e+00 -1.000000000000000000e+00 -1.000000000000000000e+00 1.017298000000000002e+03 1.393659000000000106e+03 6.109999999999999876e-01 4.304999999999999938e-01 1.139499999999999957e+00 6.864999999999999991e-01
6.000000000000000000e+00 1.430000000000000000e+03 -1.000000000000000000e+00 -1.000000000000000000e+00 -1.000000000000000000e+00 -1.000000000000000000e+00 -1.000000000000000000e+00 1.023245999999999981e+03 1.396189000000000078e+03 6.360000000000000098e-01 4.944999999999999951e-01 1.189999999999999947e+00 6.304999999999999494e-01
7.000000000000000000e+00 1.447000000000000000e+03 -1.000000000000000000e+00 -1.000000000000000000e+00 -1.000000000000000000e+00 -1.000000000000000000e+00 -1.000000000000000000e+00 1.017364000000000033e+03 1.393625000000000000e+03 5.610000000000000542e-01 4.304999999999999938e-01 1.139499999999999957e+00 6.864999999999999991e-01
7.000000000000000000e+00 1.430000000000000000e+03 -1.000000000000000000e+00 -1.000000000000000000e+00 -1.000000000000000000e+00 -1.000000000000000000e+00 -1.000000000000000000e+00 1.023182999999999993e+03 1.396154999999999973e+03 6.360000000000000098e-01 4.944999999999999951e-01 1.189999999999999947e+00 6.304999999999999494e-01
8.000000000000000000e+00 1.447000000000000000e+03 -1.000000000000000000e+00 -1.000000000000000000e+00 -1.000000000000000000e+00 -1.000000000000000000e+00 -1.000000000000000000e+00 1.017364000000000033e+03 1.393625000000000000e+03 5.610000000000000542e-01 4.304999999999999938e-01 1.139499999999999957e+00 6.864999999999999991e-01
8.000000000000000000e+00 1.430000000000000000e+03 -1.000000000000000000e+00 -1.000000000000000000e+00 -1.000000000000000000e+00 -1.000000000000000000e+00 -1.000000000000000000e+00 1.023187000000000012e+03 1.396138999999999896e+03 6.860000000000000542e-01 4.944999999999999951e-01 1.189999999999999947e+00 6.304999999999999494e-01
9.000000000000000000e+00 1.447000000000000000e+03 -1.000000000000000000e+00 -1.000000000000000000e+00 -1.000000000000000000e+00 -1.000000000000000000e+00 -1.000000000000000000e+00 1.017456999999999994e+03 1.393576999999999998e+03 6.229999999999999982e-01 4.304999999999999938e-01 1.139499999999999957e+00 6.864999999999999991e-01
9.000000000000000000e+00 1.430000000000000000e+03 -1.000000000000000000e+00 -1.000000000000000000e+00 -1.000000000000000000e+00 -1.000000000000000000e+00 -1.000000000000000000e+00 1.023586999999999989e+03 1.396122000000000071e+03 5.859999999999999654e-01 4.944999999999999951e-01 1.189999999999999947e+00 6.304999999999999494e-01
1.000000000000000000e+01 1.447000000000000000e+03 -1.000000000000000000e+00 -1.000000000000000000e+00 -1.000000000000000000e+00 -1.000000000000000000e+00 -1.000000000000000000e+00 1.017539999999999964e+03 1.393657999999999902e+03 6.109999999999999876e-01 4.304999999999999938e-01 1.139499999999999957e+00 6.864999999999999991e-01
1.000000000000000000e+01 1.430000000000000000e+03 -1.000000000000000000e+00 -1.000000000000000000e+00 -1.000000000000000000e+00 -1.000000000000000000e+00 -1.000000000000000000e+00 1.023583999999999946e+03 1.396134000000000015e+03 6.360000000000000098e-01 4.944999999999999951e-01 1.189999999999999947e+00 6.304999999999999494e-01
1.100000000000000000e+01 1.447000000000000000e+03 -1.000000000000000000e+00 -1.000000000000000000e+00 -1.000000000000000000e+00 -1.000000000000000000e+00 -1.000000000000000000e+00 1.017559999999999945e+03 1.393815000000000055e+03 6.860000000000000542e-01 4.304999999999999938e-01 1.139499999999999957e+00 6.864999999999999991e-01
1.100000000000000000e+01 1.430000000000000000e+03 -1.000000000000000000e+00 -1.000000000000000000e+00 -1.000000000000000000e+00 -1.000000000000000000e+00 -1.000000000000000000e+00 1.023677000000000021e+03 1.396164999999999964e+03 6.860000000000000542e-01 4.944999999999999951e-01 1.189999999999999947e+00 6.304999999999999494e-01
1.200000000000000000e+01 1.447000000000000000e+03 -1.000000000000000000e+00 -1.000000000000000000e+00 -1.000000000000000000e+00 -1.000000000000000000e+00 -1.000000000000000000e+00 1.017437999999999988e+03 1.393904999999999973e+03 6.610000000000000320e-01 4.304999999999999938e-01 1.139499999999999957e+00 6.864999999999999991e-01
1.200000000000000000e+01 1.430000000000000000e+03 -1.000000000000000000e+00 -1.000000000000000000e+00 -1.000000000000000000e+00 -1.000000000000000000e+00 -1.000000000000000000e+00 1.023580000000000041e+03 1.396146999999999935e+03 6.860000000000000542e-01 4.944999999999999951e-01 1.189999999999999947e+00 6.304999999999999494e-01
1.300000000000000000e+01 1.447000000000000000e+03 -1.000000000000000000e+00 -1.000000000000000000e+00 -1.000000000000000000e+00 -1.000000000000000000e+00 -1.000000000000000000e+00 1.017644999999999982e+03 1.394045000000000073e+03 6.610000000000000320e-01 4.304999999999999938e-01 1.139499999999999957e+00 6.864999999999999991e-01
1.300000000000000000e+01 1.430000000000000000e+03 -1.000000000000000000e+00 -1.000000000000000000e+00 -1.000000000000000000e+00 -1.000000000000000000e+00 -1.000000000000000000e+00 1.023703999999999951e+03 1.396189000000000078e+03 6.860000000000000542e-01 4.944999999999999951e-01 1.189999999999999947e+00 6.304999999999999494e-01
1.400000000000000000e+01 1.447000000000000000e+03 -1.000000000000000000e+00 -1.000000000000000000e+00 -1.000000000000000000e+00 -1.000000000000000000e+00 -1.000000000000000000e+00 1.017745000000000005e+03 1.394104000000000042e+03 7.610000000000000098e-01 4.304999999999999938e-01 1.139499999999999957e+00 6.864999999999999991e-01
1.400000000000000000e+01 1.430000000000000000e+03 -1.000000000000000000e+00 -1.000000000000000000e+00 -1.000000000000000000e+00 -1.000000000000000000e+00 -1.000000000000000000e+00 1.023815000000000055e+03 1.396226000000000113e+03 7.860000000000000320e-01 4.944999999999999951e-01 1.189999999999999947e+00 6.304999999999999494e-01
1.500000000000000000e+01 1.447000000000000000e+03 -1.000000000000000000e+00 -1.000000000000000000e+00 -1.000000000000000000e+00 -1.000000000000000000e+00 -1.000000000000000000e+00 1.017700000000000045e+03 1.394003999999999905e+03 5.110000000000000098e-01 4.304999999999999938e-01 1.139499999999999957e+00 6.864999999999999991e-01
1.500000000000000000e+01 1.430000000000000000e+03 -1.000000000000000000e+00 -1.000000000000000000e+00 -1.000000000000000000e+00 -1.000000000000000000e+00 -1.000000000000000000e+00 1.023913000000000011e+03 1.396258000000000038e+03 6.860000000000000542e-01 4.944999999999999951e-01 1.189999999999999947e+00 6.304999999999999494e-01
1.600000000000000000e+01 1.430000000000000000e+03 -1.000000000000000000e+00 -1.000000000000000000e+00 -1.000000000000000000e+00 -1.000000000000000000e+00 -1.000000000000000000e+00 1.024106893531055675e+03 1.396322631177018593e+03 6.860000000000000542e-01 4.945000000000000506e-01 1.189999999999999947e+00 6.304999999999999494e-01
1.600000000000000000e+01 1.447000000000000000e+03 -1.000000000000000000e+00 -1.000000000000000000e+00 -1.000000000000000000e+00 -1.000000000000000000e+00 -1.000000000000000000e+00 1.017678011920471477e+03 1.393968019506226028e+03 4.860135459903868194e-01 4.304999999999999938e-01 1.139499999999999957e+00 6.864999999999999991e-01
1.700000000000000000e+01 1.447000000000000000e+03 -1.000000000000000000e+00 -1.000000000000000000e+00 -1.000000000000000000e+00 -1.000000000000000000e+00 -1.000000000000000000e+00 1.017655999999999949e+03 1.393932000000000016e+03 4.610000000000000209e-01 4.304999999999999938e-01 1.139499999999999957e+00 6.864999999999999991e-01
1.700000000000000000e+01 1.430000000000000000e+03 -1.000000000000000000e+00 -1.000000000000000000e+00 -1.000000000000000000e+00 -1.000000000000000000e+00 -1.000000000000000000e+00 1.024009892237386794e+03 1.396290297412462223e+03 6.860000000000000542e-01 4.944999999999999396e-01 1.189999999999999947e+00 6.304999999999999494e-01
1.800000000000000000e+01 1.447000000000000000e+03 -1.000000000000000000e+00 -1.000000000000000000e+00 -1.000000000000000000e+00 -1.000000000000000000e+00 -1.000000000000000000e+00 1.017634000000000015e+03 1.393895999999999958e+03 5.110000000000000098e-01 4.304999999999999938e-01 1.139499999999999957e+00 6.864999999999999991e-01
1.800000000000000000e+01 1.430000000000000000e+03 -1.000000000000000000e+00 -1.000000000000000000e+00 -1.000000000000000000e+00 -1.000000000000000000e+00 -1.000000000000000000e+00 1.024203999999999951e+03 1.396355000000000018e+03 6.860000000000000542e-01 4.944999999999999951e-01 1.189999999999999947e+00 6.304999999999999494e-01
1.900000000000000000e+01 1.447000000000000000e+03 -1.000000000000000000e+00 -1.000000000000000000e+00 -1.000000000000000000e+00 -1.000000000000000000e+00 -1.000000000000000000e+00 1.017575000000000045e+03 1.393767000000000053e+03 5.779999999999999583e-01 4.304999999999999938e-01 1.139499999999999957e+00 6.864999999999999991e-01
