1.000000000000000000e+00 5.923000000000000000e+03 -1.000000000000000000e+00 -1.000000000000000000e+00 -1.000000000000000000e+00 -1.000000000000000000e+00 -1.000000000000000000e+00 1.100314000000000078e+03 5.279370000000000118e+02 1.691000000000000059e+00 3.750000000000000000e-01 3.724999999999999978e-01 1.000000000000000000e+00
1.000000000000000000e+00 5.925000000000000000e+03 -1.000000000000000000e+00 -1.000000000000000000e+00 -1.000000000000000000e+00 -1.000000000000000000e+00 -1.000000000000000000e+00 1.058703999999999951e+03 5.648600000000000136e+02 1.249000000000000110e+00 3.210000000000000075e-01 5.424999999999999822e-01 9.264999999999999902e-01
1.000000000000000000e+00 5.927000000000000000e+03 -1.000000000000000000e+00 -1.000000000000000000e+00 -1.000000000000000000e+00 -1.000000000000000000e+00 -1.000000000000000000e+00 1.058463999999999942e+03 5.660399999999999636e+02 1.235000000000000098e+00 2.894999999999999796e-01 4.299999999999999933e-01 8.860000000000000098e-01
1.000000000000000000e+00 5.928000000000000000e+03 -1.000000000000000000e+00 -1.000000000000000000e+00 -1.000000000000000000e+00 -1.000000000000000000e+00 -1.000000000000000000e+00 1.059006000000000085e+03 5.669600000000000364e+02 1.106999999999999984e+00 2.474999999999999978e-01 3.975000000000000200e-01 8.735000000000000542e-01
2.000000000000000000e+00 5.925000000000000000e+03 -1.000000000000000000e+00 -1.000000000000000000e+00 -1.000000000000000000e+00 -1.000000000000000000e+00 -1.000000000000000000e+00 1.059257000000000062e+03 5.644039999999999964e+02 1.256999999999999895e+00 3.210000000000000075e-01 5.424999999999999822e-01 9.264999999999999902e-01
2.000000000000000000e+00 5.927000000000000000e+03 -1.000000000000000000e+00 -1.000000000000000000e+00 -1.000000000000000000e+00 -1.000000000000000000e+00 -1.000000000000000000e+00 1.059003999999999905e+03 5.655579999999999927e+02 1.213000000000000078e+00 2.894999999999999796e-01 4.299999999999999933e-01 8.860000000000000098e-01
2.000000000000000000e+00 5.928000000000000000e+03 -1.000000000000000000e+00 -1.000000000000000000e+00 -1.000000000000000000e+00 -1.000000000000000000e+00 -1.000000000000000000e+00 1.059519999999999982e+03 5.665460000000000491e+02 1.106999999999999984e+00 2.474999999999999978e-01 3.975000000000000200e-01 8.735000000000000542e-01
3.000000000000000000e+00 5.925000000000000000e+03 -1.000000000000000000e+00 -1.000000000000000000e+00 -1.000000000000000000e+00 -1.000000000000000000e+00 -1.000000000000000000e+00 1.059810999999999922e+03 5.639470000000000027e+02 1.264000000000000012e+00 3.210000000000000075e-01 5.424999999999999822e-01 9.264999999999999902e-01
3.000000000000000000e+00 5.927000000000000000e+03 -1.000000000000000000e+00 -1.000000000000000000e+00 -1.000000000000000000e+00 -1.000000000000000000e+00 -1.000000000000000000e+00 1.059546000000000049e+03 5.650750000000000455e+02 1.189999999999999947e+00 2.894999999999999796e-01 4.299999999999999933e-01 8.860000000000000098e-01
3.000000000000000000e+00 5.928000000000000000e+03 -1.000000000000000000e+00 -1.000000000000000000e+00 -1.000000000000000000e+00 -1.000000000000000000e+00 -1.000000000000000000e+00 1.060039999999999964e+03 5.661369999999999436e+02 1.106999999999999984e+00 2.474999999999999978e-01 3.975000000000000200e-01 8.735000000000000542e-01
4.000000000000000000e+00 5.925000000000000000e+03 -1.000000000000000000e+00 -1.000000000000000000e+00 -1.000000000000000000e+00 -1.000000000000000000e+00 -1.000000000000000000e+00 1.060308999999999969e+03 5.635359999999999445e+02 1.270999999999999908e+00 3.210000000000000075e-01 5.424999999999999822e-01 9.264999999999999902e-01
4.000000000000000000e+00 5.927000000000000000e+03 -1.000000000000000000e+00 -1.000000000000000000e+00 -1.000000000000000000e+00 -1.000000000000000000e+00 -1.000000000000000000e+00 1.060032999999999902e+03 5.646399999999999864e+02 1.169999999999999929e+00 2.894999999999999796e-01 4.299999999999999933e-01 8.860000000000000098e-01
4.000000000000000000e+00 5.928000000000000000e+03 -1.000000000000000000e+00 -1.000000000000000000e+00 -1.000000000000000000e+00 -1.000000000000000000e+00 -1.000000000000000000e+00 1.060511999999999944e+03 5.657730000000000246e+02 1.106999999999999984e+00 2.474999999999999978e-01 3.975000000000000200e-01 8.735000000000000542e-01
5.000000000000000000e+00 5.925000000000000000e+03 -1.000000000000000000e+00 -1.000000000000000000e+00 -1.000000000000000000e+00 -1.000000000000000000e+00 -1.000000000000000000e+00 1.060919000000000096e+03 5.630330000000000155e+02 1.280000000000000027e+00 3.210000000000000075e-01 5.424999999999999822e-01 9.264999999999999902e-01
5.000000000000000000e+00 5.927000000000000000e+03 -1.000000000000000000e+00 -1.000000000000000000e+00 -1.000000000000000000e+00 -1.000000000000000000e+00 -1.000000000000000000e+00 1.060628999999999905e+03 5.641079999999999472e+02 1.145000000000000018e+00 2.894999999999999796e-01 4.299999999999999933e-01 8.860000000000000098e-01
5.000000000000000000e+00 5.928000000000000000e+03 -1.000000000000000000e+00 -1.000000000000000000e+00 -1.000000000000000000e+00 -1.000000000000000000e+00 -1.000000000000000000e+00 1.061089999999999918e+03 5.653310000000000173e+02 1.106999999999999984e+00 2.474999999999999978e-01 3.975000000000000200e-01 8.735000000000000542e-01
6.000000000000000000e+00 5.925000000000000000e+03 -1.000000000000000000e+00 -1.000000000000000000e+00 -1.000000000000000000e+00 -1.000000000000000000e+00 -1.000000000000000000e+00 1.061482999999999947e+03 5.625449999999999591e+02 1.264999999999999902e+00 3.210000000000000075e-01 5.424999999999999822e-01 9.264999999999999902e-01
6.000000000000000000e+00 5.927000000000000000e+03 -1.000000000000000000e+00 -1.000000000000000000e+00 -1.000000000000000000e+00 -1.000000000000000000e+00 -1.000000000000000000e+00 1.061169000000000096e+03 5.636259999999999764e+02 1.122000000000000108e+00 2.894999999999999796e-01 4.299999999999999933e-01 8.860000000000000098e-01
6.000000000000000000e+00 5.928000000000000000e+03 -1.000000000000000000e+00 -1.000000000000000000e+00 -1.000000000000000000e+00 -1.000000000000000000e+00 -1.000000000000000000e+00 1.061614000000000033e+03 5.649299999999999500e+02 1.106999999999999984e+00 2.474999999999999978e-01 3.975000000000000200e-01 8.735000000000000542e-01
7.000000000000000000e+00 5.925000000000000000e+03 -1.000000000000000000e+00 -1.000000000000000000e+00 -1.000000000000000000e+00 -1.000000000000000000e+00 -1.000000000000000000e+00 1.061991999999999962e+03 5.621050000000000182e+02 1.252000000000000002e+00 3.210000000000000075e-01 5.424999999999999822e-01 9.264999999999999902e-01
7.000000000000000000e+00 5.927000000000000000e+03 -1.000000000000000000e+00 -1.000000000000000000e+00 -1.000000000000000000e+00 -1.000000000000000000e+00 -1.000000000000000000e+00 1.061673000000000002e+03 5.632319999999999709e+02 1.129000000000000004e+00 2.894999999999999796e-01 4.299999999999999933e-01 8.860000000000000098e-01
7.000000000000000000e+00 5.928000000000000000e+03 -1.000000000000000000e+00 -1.000000000000000000e+00 -1.000000000000000000e+00 -1.000000000000000000e+00 -1.000000000000000000e+00 1.062096999999999980e+03 5.645879999999999654e+02 1.116000000000000103e+00 2.474999999999999978e-01 3.975000000000000200e-01 8.735000000000000542e-01
8.000000000000000000e+00 5.925000000000000000e+03 -1.000000000000000000e+00 -1.000000000000000000e+00 -1.000000000000000000e+00 -1.000000000000000000e+00 -1.000000000000000000e+00 1.062557000000000016e+03 5.616169999999999618e+02 1.237000000000000099e+00 3.210000000000000075e-01 5.424999999999999822e-01 9.264999999999999902e-01
8.000000000000000000e+00 5.927000000000000000e+03 -1.000000000000000000e+00 -1.000000000000000000e+00 -1.000000000000000000e+00 -1.000000000000000000e+00 -1.000000000000000000e+00 1.062233999999999924e+03 5.627970000000000255e+02 1.135999999999999899e+00 2.894999999999999796e-01 4.299999999999999933e-01 8.860000000000000098e-01
8.000000000000000000e+00 5.928000000000000000e+03 -1.000000000000000000e+00 -1.000000000000000000e+00 -1.000000000000000000e+00 -1.000000000000000000e+00 -1.000000000000000000e+00 1.062631000000000085e+03 5.642069999999999936e+02 1.125999999999999890e+00 2.474999999999999978e-01 3.975000000000000200e-01 8.735000000000000542e-01
9.000000000000000000e+00 5.925000000000000000e+03 -1.000000000000000000e+00 -1.000000000000000000e+00 -1.000000000000000000e+00 -1.000000000000000000e+00 -1.000000000000000000e+00 1.063127999999999929e+03 5.611169999999999618e+02 1.221000000000000085e+00 3.210000000000000075e-01 5.424999999999999822e-01 9.264999999999999902e-01
9.000000000000000000e+00 5.927000000000000000e+03 -1.000000000000000000e+00 -1.000000000000000000e+00 -1.000000000000000000e+00 -1.000000000000000000e+00 -1.000000000000000000e+00 1.062853000000000065e+03 5.623189999999999600e+02 1.143999999999999906e+00 2.894999999999999796e-01 4.299999999999999933e-01 8.860000000000000098e-01
9.000000000000000000e+00 5.928000000000000000e+03 -1.000000000000000000e+00 -1.000000000000000000e+00 -1.000000000000000000e+00 -1.000000000000000000e+00 -1.000000000000000000e+00 1.063207000000000107e+03 5.637709999999999582e+02 1.137000000000000011e+00 2.474999999999999978e-01 3.975000000000000200e-01 8.735000000000000542e-01
1.000000000000000000e+01 5.925000000000000000e+03 -1.000000000000000000e+00 -1.000000000000000000e+00 -1.000000000000000000e+00 -1.000000000000000000e+00 -1.000000000000000000e+00 1.063645999999999958e+03 5.606630000000000109e+02 1.207000000000000073e+00 3.210000000000000075e-01 5.424999999999999822e-01 9.264999999999999902e-01
1.000000000000000000e+01 5.927000000000000000e+03 -1.000000000000000000e+00 -1.000000000000000000e+00 -1.000000000000000000e+00 -1.000000000000000000e+00 -1.000000000000000000e+00 1.063414999999999964e+03 5.618849999999999909e+02 1.151999999999999913e+00 2.894999999999999796e-01 4.299999999999999933e-01 8.860000000000000098e-01
1.000000000000000000e+01 5.928000000000000000e+03 -1.000000000000000000e+00 -1.000000000000000000e+00 -1.000000000000000000e+00 -1.000000000000000000e+00 -1.000000000000000000e+00 1.063719000000000051e+03 5.633600000000000136e+02 1.147000000000000020e+00 2.474999999999999978e-01 3.975000000000000200e-01 8.735000000000000542e-01
1.100000000000000000e+01 5.925000000000000000e+03 -1.000000000000000000e+00 -1.000000000000000000e+00 -1.000000000000000000e+00 -1.000000000000000000e+00 -1.000000000000000000e+00 1.064163999999999987e+03 5.602089999999999463e+02 1.191999999999999948e+00 3.210000000000000075e-01 5.424999999999999822e-01 9.264999999999999902e-01
1.100000000000000000e+01 5.927000000000000000e+03 -1.000000000000000000e+00 -1.000000000000000000e+00 -1.000000000000000000e+00 -1.000000000000000000e+00 -1.000000000000000000e+00 1.063977000000000089e+03 5.614510000000000218e+02 1.159000000000000030e+00 2.894999999999999796e-01 4.299999999999999933e-01 8.860000000000000098e-01
1.100000000000000000e+01 5.928000000000000000e+03 -1.000000000000000000e+00 -1.000000000000000000e+00 -1.000000000000000000e+00 -1.000000000000000000e+00 -1.000000000000000000e+00 1.064231999999999971e+03 5.629500000000000455e+02 1.157000000000000028e+00 2.474999999999999978e-01 3.975000000000000200e-01 8.735000000000000542e-01
1.200000000000000000e+01 5.925000000000000000e+03 -1.000000000000000000e+00 -1.000000000000000000e+00 -1.000000000000000000e+00 -1.000000000000000000e+00 -1.000000000000000000e+00 1.064682999999999993e+03 5.597540000000000191e+02 1.177999999999999936e+00 3.210000000000000075e-01 5.424999999999999822e-01 9.264999999999999902e-01
1.200000000000000000e+01 5.927000000000000000e+03 -1.000000000000000000e+00 -1.000000000000000000e+00 -1.000000000000000000e+00 -1.000000000000000000e+00 -1.000000000000000000e+00 1.064470000000000027e+03 5.610860000000000127e+02 1.175999999999999934e+00 2.894999999999999796e-01 4.299999999999999933e-01 8.860000000000000098e-01
1.200000000000000000e+01 5.928000000000000000e+03 -1.000000000000000000e+00 -1.000000000000000000e+00 -1.000000000000000000e+00 -1.000000000000000000e+00 -1.000000000000000000e+00 1.064718000000000075e+03 5.624790000000000418e+02 1.173999999999999932e+00 2.474999999999999978e-01 3.975000000000000200e-01 8.735000000000000542e-01
1.300000000000000000e+01 5.925000000000000000e+03 -1.000000000000000000e+00 -1.000000000000000000e+00 -1.000000000000000000e+00 -1.000000000000000000e+00 -1.000000000000000000e+00 1.065201000000000022e+03 5.593010000000000446e+02 1.163000000000000034e+00 3.210000000000000075e-01 5.424999999999999822e-01 9.264999999999999902e-01
1.300000000000000000e+01 5.927000000000000000e+03 -1.000000000000000000e+00 -1.000000000000000000e+00 -1.000000000000000000e+00 -1.000000000000000000e+00 -1.000000000000000000e+00 1.064950000000000045e+03 5.607050000000000409e+02 1.193999999999999950e+00 2.894999999999999796e-01 4.299999999999999933e-01 8.860000000000000098e-01
1.300000000000000000e+01 5.928000000000000000e+03 -1.000000000000000000e+00 -1.000000000000000000e+00 -1.000000000000000000e+00 -1.000000000000000000e+00 -1.000000000000000000e+00 1.065199000000000069e+03 5.620040000000000191e+02 1.189999999999999947e+00 2.474999999999999978e-01 3.975000000000000200e-01 8.735000000000000542e-01
1.400000000000000000e+01 5.925000000000000000e+03 -1.000000000000000000e+00 -1.000000000000000000e+00 -1.000000000000000000e+00 -1.000000000000000000e+00 -1.000000000000000000e+00 1.065719000000000051e+03 5.588469999999999800e+02 1.147999999999999909e+00 3.210000000000000075e-01 5.424999999999999822e-01 9.264999999999999902e-01
1.400000000000000000e+01 5.927000000000000000e+03 -1.000000000000000000e+00 -1.000000000000000000e+00 -1.000000000000000000e+00 -1.000000000000000000e+00 -1.000000000000000000e+00 1.065416999999999916e+03 5.603060000000000400e+02 1.211000000000000076e+00 2.894999999999999796e-01 4.299999999999999933e-01 8.860000000000000098e-01
1.400000000000000000e+01 5.928000000000000000e+03 -1.000000000000000000e+00 -1.000000000000000000e+00 -1.000000000000000000e+00 -1.000000000000000000e+00 -1.000000000000000000e+00 1.065673999999999978e+03 5.615220000000000482e+02 1.207000000000000073e+00 2.474999999999999978e-01 3.975000000000000200e-01 8.735000000000000542e-01
1.500000000000000000e+01 5.925000000000000000e+03 -1.000000000000000000e+00 -1.000000000000000000e+00 -1.000000000000000000e+00 -1.000000000000000000e+00 -1.000000000000000000e+00 1.066250000000000000e+03 5.584059999999999491e+02 1.151000000000000023e+00 3.210000000000000075e-01 5.424999999999999822e-01 9.264999999999999902e-01
1.500000000000000000e+01 5.927000000000000000e+03 -1.000000000000000000e+00 -1.000000000000000000e+00 -1.000000000000000000e+00 -1.000000000000000000e+00 -1.000000000000000000e+00 1.065869999999999891e+03 5.598909999999999627e+02 1.229000000000000092e+00 2.894999999999999796e-01 4.299999999999999933e-01 8.860000000000000098e-01
1.500000000000000000e+01 5.928000000000000000e+03 -1.000000000000000000e+00 -1.000000000000000000e+00 -1.000000000000000000e+00 -1.000000000000000000e+00 -1.000000000000000000e+00 1.066145999999999958e+03 5.610359999999999445e+02 1.223999999999999977e+00 2.474999999999999978e-01 3.975000000000000200e-01 8.735000000000000542e-01
1.600000000000000000e+01 5.927000000000000000e+03 -1.000000000000000000e+00 -1.000000000000000000e+00 -1.000000000000000000e+00 -1.000000000000000000e+00 -1.000000000000000000e+00 1.066307999999999993e+03 5.594600000000000364e+02 1.245999999999999996e+00 2.894999999999999796e-01 4.299999999999999933e-01 8.860000000000000098e-01
1.600000000000000000e+01 5.928000000000000000e+03 -1.000000000000000000e+00 -1.000000000000000000e+00 -1.000000000000000000e+00 -1.000000000000000000e+00 -1.000000000000000000e+00 1.066615000000000009e+03 5.605470000000000255e+02 1.239999999999999991e+00 2.474999999999999978e-01 3.975000000000000200e-01 8.735000000000000542e-01
1.600000000000000000e+01 5.925000000000000000e+03 -1.000000000000000000e+00 -1.000000000000000000e+00 -1.000000000000000000e+00 -1.000000000000000000e+00 -1.000000000000000000e+00 1.066782231707999927e+03 5.579677209315343589e+02 1.152998992330515726e+00 3.210000000000000075e-01 5.424999999999999822e-01 9.264999999999999902e-01
1.700000000000000000e+01 5.925000000000000000e+03 -1.000000000000000000e+00 -1.000000000000000000e+00 -1.000000000000000000e+00 -1.000000000000000000e+00 -1.000000000000000000e+00 1.067315000000000055e+03 5.575289999999999964e+02 1.155000000000000027e+00 3.210000000000000075e-01 5.424999999999999822e-01 9.264999999999999902e-01
1.700000000000000000e+01 5.927000000000000000e+03 -1.000000000000000000e+00 -1.000000000000000000e+00 -1.000000000000000000e+00 -1.000000000000000000e+00 -1.000000000000000000e+00 1.066799999999999955e+03 5.589729999999999563e+02 1.223000000000000087e+00 2.894999999999999796e-01 4.299999999999999933e-01 8.860000000000000098e-01
1.700000000000000000e+01 5.928000000000000000e+03 -1.000000000000000000e+00 -1.000000000000000000e+00 -1.000000000000000000e+00 -1.000000000000000000e+00 -1.000000000000000000e+00 1.067084000000000060e+03 5.600589999999999691e+02 1.256999999999999895e+00 2.474999999999999978e-01 3.975000000000000200e-01 8.735000000000000542e-01
