1.200000000000000000e+01 4.660000000000000000e+02 -1.000000000000000000e+00 -1.000000000000000000e+00 -1.000000000000000000e+00 -1.000000000000000000e+00 -1.000000000000000000e+00 9.602569999999999482e+02 6.533540000000000418e+02 7.890000000000000346e-01 2.635000000000000120e-01 7.864999999999999769e-01 5.494999999999999885e-01
1.300000000000000000e+01 4.660000000000000000e+02 -1.000000000000000000e+00 -1.000000000000000000e+00 -1.000000000000000000e+00 -1.000000000000000000e+00 -1.000000000000000000e+00 9.602569999999999482e+02 6.533540000000000418e+02 7.890000000000000346e-01 2.635000000000000120e-01 7.864999999999999769e-01 5.494999999999999885e-01
1.400000000000000000e+01 4.660000000000000000e+02 -1.000000000000000000e+00 -1.000000000000000000e+00 -1.000000000000000000e+00 -1.000000000000000000e+00 -1.000000000000000000e+00 9.602540000000000191e+02 6.533519999999999754e+02 7.810000000000000275e-01 2.635000000000000120e-01 7.864999999999999769e-01 5.494999999999999885e-01
1.400000000000000000e+01 4.690000000000000000e+02 -1.000000000000000000e+00 -1.000000000000000000e+00 -1.000000000000000000e+00 -1.000000000000000000e+00 -1.000000000000000000e+00 9.609489999999999554e+02 6.525320000000000391e+02 9.859999999999999876e-01 2.665000000000000147e-01 7.305000000000000382e-01 5.540000000000000480e-01
1.500000000000000000e+01 4.660000000000000000e+02 -1.000000000000000000e+00 -1.000000000000000000e+00 -1.000000000000000000e+00 -1.000000000000000000e+00 -1.000000000000000000e+00 9.602509999999999764e+02 6.533500000000000227e+02 7.720000000000000195e-01 2.635000000000000120e-01 7.864999999999999769e-01 5.494999999999999885e-01
1.500000000000000000e+01 4.690000000000000000e+02 -1.000000000000000000e+00 -1.000000000000000000e+00 -1.000000000000000000e+00 -1.000000000000000000e+00 -1.000000000000000000e+00 9.609529999999999745e+02 6.525349999999999682e+02 9.260000000000000453e-01 2.665000000000000147e-01 7.305000000000000382e-01 5.540000000000000480e-01
1.600000000000000000e+01 4.660000000000000000e+02 -1.000000000000000000e+00 -1.000000000000000000e+00 -1.000000000000000000e+00 -1.000000000000000000e+00 -1.000000000000000000e+00 9.602480000000000473e+02 6.533479999999999563e+02 7.640000000000000124e-01 2.635000000000000120e-01 7.864999999999999769e-01 5.494999999999999885e-01
1.600000000000000000e+01 4.690000000000000000e+02 -1.000000000000000000e+00 -1.000000000000000000e+00 -1.000000000000000000e+00 -1.000000000000000000e+00 -1.000000000000000000e+00 9.609560000000000173e+02 6.525370000000000346e+02 8.659999999999999920e-01 2.665000000000000147e-01 7.305000000000000382e-01 5.540000000000000480e-01
1.700000000000000000e+01 4.660000000000000000e+02 -1.000000000000000000e+00 -1.000000000000000000e+00 -1.000000000000000000e+00 -1.000000000000000000e+00 -1.000000000000000000e+00 9.602440000000000282e+02 6.533460000000000036e+02 7.560000000000000053e-01 2.635000000000000120e-01 7.864999999999999769e-01 5.494999999999999885e-01
1.700000000000000000e+01 4.690000000000000000e+02 -1.000000000000000000e+00 -1.000000000000000000e+00 -1.000000000000000000e+00 -1.000000000000000000e+00 -1.000000000000000000e+00 9.609600000000000364e+02 6.525389999999999873e+02 8.060000000000000497e-01 2.665000000000000147e-01 7.305000000000000382e-01 5.540000000000000480e-01
1.800000000000000000e+01 4.660000000000000000e+02 -1.000000000000000000e+00 -1.000000000000000000e+00 -1.000000000000000000e+00 -1.000000000000000000e+00 -1.000000000000000000e+00 9.602409999999999854e+02 6.533440000000000509e+02 7.469999999999999973e-01 2.635000000000000120e-01 7.864999999999999769e-01 5.494999999999999885e-01
1.800000000000000000e+01 4.690000000000000000e+02 -1.000000000000000000e+00 -1.000000000000000000e+00 -1.000000000000000000e+00 -1.000000000000000000e+00 -1.000000000000000000e+00 9.609629999999999654e+02 6.525420000000000300e+02 7.459999999999999964e-01 2.665000000000000147e-01 7.305000000000000382e-01 5.540000000000000480e-01
1.900000000000000000e+01 4.660000000000000000e+02 -1.000000000000000000e+00 -1.000000000000000000e+00 -1.000000000000000000e+00 -1.000000000000000000e+00 -1.000000000000000000e+00 9.602380000000000564e+02 6.533419999999999845e+02 7.389999999999999902e-01 2.635000000000000120e-01 7.864999999999999769e-01 5.494999999999999885e-01
1.900000000000000000e+01 4.690000000000000000e+02 -1.000000000000000000e+00 -1.000000000000000000e+00 -1.000000000000000000e+00 -1.000000000000000000e+00 -1.000000000000000000e+00 9.609669999999999845e+02 6.525439999999999827e+02 6.860000000000000542e-01 2.665000000000000147e-01 7.305000000000000382e-01 5.540000000000000480e-01
