9.000000000000000000e+00 4.744000000000000000e+03 -1.000000000000000000e+00 -1.000000000000000000e+00 -1.000000000000000000e+00 -1.000000000000000000e+00 -1.000000000000000000e+00 1.433345000000000027e+03 3.082021999999999935e+03 1.165000000000000036e+00 3.069999999999999951e-01 7.974999999999999867e-01 6.185000000000000497e-01
1.000000000000000000e+01 4.744000000000000000e+03 -1.000000000000000000e+00 -1.000000000000000000e+00 -1.000000000000000000e+00 -1.000000000000000000e+00 -1.000000000000000000e+00 1.433327999999999975e+03 3.082009000000000015e+03 1.114999999999999991e+00 3.069999999999999951e-01 7.974999999999999867e-01 6.185000000000000497e-01
1.100000000000000000e+01 4.744000000000000000e+03 -1.000000000000000000e+00 -1.000000000000000000e+00 -1.000000000000000000e+00 -1.000000000000000000e+00 -1.000000000000000000e+00 1.433292999999999893e+03 3.081981999999999971e+03 1.114999999999999991e+00 3.069999999999999951e-01 7.974999999999999867e-01 6.185000000000000497e-01
1.200000000000000000e+01 4.744000000000000000e+03 -1.000000000000000000e+00 -1.000000000000000000e+00 -1.000000000000000000e+00 -1.000000000000000000e+00 -1.000000000000000000e+00 1.433267000000000053e+03 3.081961999999999989e+03 9.649999999999999689e-01 3.069999999999999951e-01 7.974999999999999867e-01 6.185000000000000497e-01
1.300000000000000000e+01 4.744000000000000000e+03 -1.000000000000000000e+00 -1.000000000000000000e+00 -1.000000000000000000e+00 -1.000000000000000000e+00 -1.000000000000000000e+00 1.433269999999999982e+03 3.082047999999999774e+03 9.649999999999999689e-01 3.069999999999999951e-01 7.974999999999999867e-01 6.185000000000000497e-01
1.400000000000000000e+01 4.744000000000000000e+03 -1.000000000000000000e+00 -1.000000000000000000e+00 -1.000000000000000000e+00 -1.000000000000000000e+00 -1.000000000000000000e+00 1.433269999999999982e+03 3.082047999999999774e+03 8.149999999999999467e-01 3.069999999999999951e-01 7.974999999999999867e-01 6.185000000000000497e-01
1.500000000000000000e+01 4.744000000000000000e+03 -1.000000000000000000e+00 -1.000000000000000000e+00 -1.000000000000000000e+00 -1.000000000000000000e+00 -1.000000000000000000e+00 1.433326999999999998e+03 3.082090999999999894e+03 7.650000000000000133e-01 3.069999999999999951e-01 7.974999999999999867e-01 6.185000000000000497e-01
1.600000000000000000e+01 4.744000000000000000e+03 -1.000000000000000000e+00 -1.000000000000000000e+00 -1.000000000000000000e+00 -1.000000000000000000e+00 -1.000000000000000000e+00 1.433304000000000087e+03 3.082086999999999989e+03 6.149999999999999911e-01 3.069999999999999951e-01 7.974999999999999867e-01 6.185000000000000497e-01
1.700000000000000000e+01 4.744000000000000000e+03 -1.000000000000000000e+00 -1.000000000000000000e+00 -1.000000000000000000e+00 -1.000000000000000000e+00 -1.000000000000000000e+00 1.433286000000000058e+03 3.082059999999999945e+03 5.649999999999999467e-01 3.069999999999999951e-01 7.974999999999999867e-01 6.185000000000000497e-01
1.800000000000000000e+01 4.744000000000000000e+03 -1.000000000000000000e+00 -1.000000000000000000e+00 -1.000000000000000000e+00 -1.000000000000000000e+00 -1.000000000000000000e+00 1.433296000000000049e+03 3.082068000000000211e+03 4.899999999999999911e-01 3.069999999999999951e-01 7.974999999999999867e-01 6.185000000000000497e-01
1.900000000000000000e+01 4.744000000000000000e+03 -1.000000000000000000e+00 -1.000000000000000000e+00 -1.000000000000000000e+00 -1.000000000000000000e+00 -1.000000000000000000e+00 1.433296000000000049e+03 3.082068000000000211e+03 3.400000000000000244e-01 3.069999999999999951e-01 7.974999999999999867e-01 6.185000000000000497e-01
2.000000000000000000e+01 4.744000000000000000e+03 -1.000000000000000000e+00 -1.000000000000000000e+00 -1.000000000000000000e+00 -1.000000000000000000e+00 -1.000000000000000000e+00 1.433384999999999991e+03 3.082135000000000218e+03 2.030000000000000138e-01 3.069999999999999951e-01 7.974999999999999867e-01 6.185000000000000497e-01
2.100000000000000000e+01 4.744000000000000000e+03 -1.000000000000000000e+00 -1.000000000000000000e+00 -1.000000000000000000e+00 -1.000000000000000000e+00 -1.000000000000000000e+00 1.433340999999999894e+03 3.082101000000000113e+03 1.459999999999999909e-01 3.069999999999999951e-01 7.974999999999999867e-01 6.185000000000000497e-01
2.200000000000000000e+01 4.744000000000000000e+03 -1.000000000000000000e+00 -1.000000000000000000e+00 -1.000000000000000000e+00 -1.000000000000000000e+00 -1.000000000000000000e+00 1.433296000000000049e+03 3.082068000000000211e+03 8.999999999999999667e-02 3.069999999999999951e-01 7.974999999999999867e-01 6.185000000000000497e-01
